DISCOMFITURE	D IH S K AH M F IH CH ER
TROPE	T R OW P
HUSKING	HH AH S K IH NG
UNSCRATCHED	AH N S K R AE CH T
FOOT'S	F UH TS
SILENTNESS	S AY L AH N T N AH S
EVERLASTINGLY	EH V ER L AE S T IH NG L IY
MATCHLESSE	M AE CH L AH S
BOSKY	B AA S IY
ACIS	EY S IY Z
OYSTERCATCHER	OY S T ER K AE CH ER
BIRTHDATE	B ER TH D EY T
GNOME'S	N OW M Z
PARSNIPS	P AA R S N IH P S
SCATTEREST	S K AE T ER AH S T
FUMETTE	F Y UW M EH T
SKYLARK'S	S K AY L AA R K S
MAINTOP	M EY N T AA P
ZAMES	Z EY M Z
MAGRITTE'S	M AE G R IH T AH Z
O'ERLOOKING	AH AH R L AH K AH NG
LOURS	L OW Y AH R Z
IMBROS	IH M B R AA Z
BOMBSQUAD	B AA M S K W AA D
SILAGE	S AY L AH JH
GRIEVETH	G R IY V IH TH
FAWN'S	F AO N Z
THE'STINGRAY	DH AH Z T IH N G R EY
HEATHENISH	HH IY DH AH N IH SH
SNOWCAPS	S N OW K AE P S
DAGGER'S	D AE G ER Z
WREATHED	R IY DH D
LYTTELTON	L IH T EH L T AH N
DIONYSIA	D AY AH N IH ZH IY AH
AHHS	AE HH S
PLUMERIA	P L UW M IY R IY AH
FORCEFULL	F OW R S F UH L
FOEMEN	F OW M EH N
PEACE'S	P IY S IX Z
LINIMENT	L IH N AH M AH N T
FENCEPOST	F EH N S P OW S T
SLATTERNS	S L AE T AH R N Z
CROAKED	K R OW K T
EROGENOUS	AH R AA JH AH N AH S
TODDLER'S	T AA D L ER Z
SUNDECK	S AH N D EH K
LIPSTICK'S	L IH P S T IH K S
GRANDPAPA	G R AE N D P AA P AH
DOBRUJA'S	D AA B R UW JH AH Z
TOREADORS	T OW R EY D ER Z
SMITING	S M AY T AH NG
EXALTATION	IH G Z AO L T EY SH AH N
SAMMICH	S AE M AH CH
GAPES	G EY P S
MERCHANTABLE	M ER CH AH N T AH B AH L
GERIZIM	JH EH R AH Z AH M
PUB'S	P AH B Z
NUBILE	N UW B AY L
BULBUL	B UH L B AH L
PICKERELWEED	P IH K AH R EH L W IY D
WUZ	W AH Z
SPIDERWEB	S P AY D ER W EH B
TETZEL	T EH T S AH L
POPLAR'S	P AA P L ER Z
BLOWENS	B L OW AH N Z
JIMSON	JH IH M S AH N
PENTATEUCH	P EH N T EY T Y UW CH
STAMENS	S T EY M AH N Z
LAMED	L EY M D
STITCHERY	S T IH CH AH R IY
BURIN	B Y UH R AH N
LANGUAGETHE	L AE N G W AH JH AH DH
MANGOS	M AE N G OW Z
STIPPLE	S T IH P AH L
LOCHIEL	L AH CH IY L
REMONSTRATE	R IH M AA N S T R AH T
MAWS	M AO Z
THUNDERCLOUD	TH AH N D ER K L AW D
PERFECTEST	P ER F AH K T AH S T
MESSE	M EH S
WATERSKI	W AO T ER S K IY
FRINGED	F R IH N JH D
SCANDERBEG	S K AE N D AH R B AH G
IMPORTUNATE	IH M P ER T UW N AH T
ZULEIKA	Z UW L IY K AH
SCYLDINGS	S IH L D AH NG Z
CALVARY'S	K AE L V ER IY Z
MAYST	M EY S T
HYPOLITO	HH AH P AA L AH T OW
LONGINGNESS	L AO NG IH NG N AH S
RAGOUTS	R AE G AW T S
DELOS	D AH L AA Z
DECEIVES	D IH S IY V Z
SQUEEGEES	S K W IY JH IY Z
MARSIAN	M AA R Z IY AH N
ANAHIT	AE N AH HH AH T
KETTY	K EH T IY
NEST'S	N EH S TS
YUNUS	Y UW N AH S
LACING	L EY S IH NG
MUDDIES	M AH D IY Z
SWOLN	S W OW L N
MANITO	M AE N AH T OW
KNOTHOLE	N AA T HH OW L
SWEDENBORG	S W AH D EH N B AH R G
DISTENDS	D IH S T EH N D Z
SMILEING	S M AY L IH NG
SIFTETH	S IH F T IH TH
XVII	Z V IY
RICOCHETS	R IH K AH SH EY Z
STORKS	S T AO R K S
CRAWDAD'S	K R AO D AH D Z
UNACQUAINTED	AH N AH K W EY N T IH D
SPARSH	S P AA R SH
FISHERFOLK	F IH SH ER F OW K
AINT	EY N T
MIAOW	M AY AH OW
MUGOO	M Y UW G UW
IMPLOR'D	IH M P L AO R D
DUSKY	D AH S K IY
DESPONDING	D IH S P AA N D IH NG
AKROKERAUNIAN	AE K R AA K AH R AO N IY AH N
PIERLESS	P IH ER L AH S
DINGHIES	D IH NG IY Z
ADZE	AE D Z
GAINE	G EY N
BELLRINGER'S	B EH L R IH NG ER Z
COMBINE'S	K AA M B AY N Z
FOUNT	F AW N T
BOGGY	B AO G IY
CHIMARIOT	CH AH M AE R IY AH T
BASTWICK	B AE S T W IH K
SUPERL	S UW P AH R L
LOWLINESS	L OW L IY N AH S
COFFINI	K AA F IH N IY
PELTRIES	P EH L T R IY Z
REWORKS	R IY W ER K S
SIGHINGS	S AY IH NG Z
SHEEPDOG	SH IY P D AO G
SEABREEZE	S IY B R IY Z
ATHANASE	AE TH AH N EY Z
HYDRANGEA	HH IH D R AE N JH IY AH
CACHUCHA	K AE CH AH CH AH
MOSSED	M AO S T
FINISH'D	F IH N IH SH D
SUNTANS	S AH N T AE N Z
ULR	AH L R
WASHDAY	W AA SH D EY
BRAVERY'S	B R EY V ER IY Z
NUTHIN	N AH TH AH N
MOULT	M OW L T
LOVELINESS	L AH V L IY N AH S
SOLACING	S AA L AH S IH NG
WORTHED	W ER TH T
COGNATE	K AA G N EY T
ENVIES	EH N V IY Z
FORBEAR	F AO R B AE ER
THOREAU'S	TH ER OW Z
XIII	Z IY IY
HUMPS	HH AH M P S
STUBBLED	S T AH B AH L D
SOOTHFAST	S UW TH AH S T
CITROUILLE	S IH T R AW AH L
REVELLING	R EH V AH L IH NG
NUTHATCH'S	N AH T HH AE CH IH Z
FLOWER'S	F L AW ER Z
PRECIOSA	P R IY S AY AH S AH
BONFIRE'S	B AA N F AY ER Z
UNFAITH	AH N F EY TH
SPIRING	S P AY ER IH NG
GARLANDED	G AA R L AH N D IH D
SOLITUDES	S AA L AH T UW D Z
SHED'S	SH EH D Z
CURDLED	K ER D AH L D
DIFFER'D	D IH F ER D
CATALOGUE'S	K AE T AH L AO G Z
PLOUGHMAN	P L AW M AH N
KWASIND	K W AH S AY N D
NIGHTCRAWLERS	N AY T K R AO L ER Z
LAUNDRESS	L AO N D R AH S
DOMO	D OW M OW
SNOWDRIFTS	S N OW D R IH F T S
MYNAHS	M IH N AH Z
BAGWELL'S	B AE G W EH L Z
WOODCARVER'S	W UH D K AA R V ER Z
ERST	AH R S T
NEED'S	N IY D Z
MANTELPIECE	M AE N T AH L P IY S
BURKA	B AH R K AH
UNWARD	AH N W AO R D
II	IY
IMMENSITY	IH M EH N S AH T IY
PIPISTRELLE'S	P IH P AH S T R EH L AH Z
TRACERY	T R EY S AH R IY
ENMITIE	EH N M AY T IY
SOUTHWARDS	S AW TH W ER D Z
HURLS	HH ER L Z
LECHERS	L EH CH ER Z
LILACSCENT	L AY L AE K S EH N T
UNRETURNED	AH N R IY T ER N D
ETON'S	IY T AH N Z
PLENTEOUS	P L EH N T IY AH S
XMAS	Z M AE Z
MELANCHOLIA	M EH L AH NG K OW L Y AH
WHEREWITH	W EH ER W IH TH
DIVINER	D AH V AY N ER
GODO	G OW D UW
PUPPY'S	P AH P IY Z
EGRETS	IY G R AH T S
KNOBBLY	N AA B L IY
CONJOINT	K AH N JH OY N T
BINYON	B IH N IY AO N
BYSTANDING	B AY S T AE N D IH NG
FIENDISHLY	F IY N D IH SH L IY
EGRET'S	EH G R AH TS
DERECHO	D IH R AH CH OW
ARMFUL	AA R M F UH L
GODLIKE	G AA D L AY K
VII	V IY
SYNTAXES	S IH N T AE K S IH Z
RAMBUTAN	R AE M B Y UW T AH N
HAWK'S	HH AO K S
UNGLOVED	AH N G L AH V D
HUS	HH AH Z
SERAPH	S EH R AH F
SALTINGS	S AO L T IH NG Z
CREASED	K R IY S T
GLEAM'D	G L IY M D
FLUTE'S	F L UW TS
RECEPTIONIST'S	R IH S EH P SH AH N IH S TS
FALLETH	F AE L IH TH
HUMMINGBIRD'S	HH AH M IH NG B ER D Z
STASIS	S T EY S AH S
GIF	JH IH F
NASTURTIUM	N AE S T AH R T IY AH M
FUSHIN'S	F AH SH AH N Z
FLOWERPOTS	F L AW ER P AA T S
COOCH	K OW AA CH
UNLOCKS	AH N L AA K S
CRAYONED	K R EY AA N D
IONIA	AY OW N Y AH
SUPPLANTER'S	S AH P L AE N T ER Z
FLITTER	F L IH T ER
SPLAYED	S P L EY D
CHILDHOOD'S	CH AY L D HH UH D Z
SCORNING	S K AO R N IH NG
CANTOS	K AE N T OW Z
SOE'ER	S OW AH AH R
BALCONY'S	B AE L K AH N IY Z
HORSEHAIR	HH AO R S HH EH R
GERYON	JH EH R AY AH N
EBOOKS	EH B AH K S
PP	P IY P
ESTAUGH	EH S T AH
CYNOMYOPSIS	S AH N AA M AY AA P S AH S
SHROVE	SH R OW V
MOCKINGBIRD'S	M AA K IH NG B ER D Z
WEATHERCOCKS	W EH DH ER K AA K S
EMPYREAN	IH M P AY R IY AH N
WILNIAN	W IH L N IY AH N
AMPHICTRION	AE M F IH K T R IY AH N
EV'RY	EH V R IY
LOINS	L OY N Z
FINGAL	F IH N G AE L
TRAMMELS	T R AE M AH L Z
ISKANDER	IH S AE N D AH R
SNOWMELT	S N OW M EH L T
COXSWAIN'S	K AA Z S W EY N Z
HANDPRINT	HH AE N D P R IH N T
LIQUIDAMBER	L IH K W AH D AE M B ER
UNATTEMPTED	AH N AH T EH M P T IH D
UMBRAGEOUS	AH M B R IH JH IY AH S
DROPT	D R AA P T
SULLENLY	S AH L AH N L IY
EPISTLES	IH P IH S AH L Z
FLAGON	F L AE G AO N
UNCOMBED	AH N K AH M B EH D
MONARCHIZE	M AA N AA R K AY Z
SPIRITUALIZED	S P IH R IH CH AH W AH L AY Z D
CUMULUS	K Y UW M Y AH L AH S
MUSKETRY	M AH S K AH T R IY
AEREAL	EH R IY AH L
SHINS	SH IH N Z
WASHBASINS	W AA SH B EY S AH N Z
PHILOSTRATUS	F IH L AH S T R EY T AH S
THUNDER'S	TH AH N D ER Z
ITHAKAS	IH TH AH K AH Z
SILVERLY	S IH L V ER L IY
SOAPSUDS	S OW P S AH D Z
NICKERING	N IH K ER IH NG
HOUSETOPS	HH AW S T AA P S
OPINION'S	AH P IH N Y AH N Z
TOMBO	T AA M B OW
GUMTREES	G AH M T R IY Z
GOEST	G OW AH S T
SPITTLEBUGS	S P IH T AH L B AH G Z
PRISCELLA'S	P R IH S EH L AH Z
PALLS	P AO L Z
ROLLERSKATE	R OW L ER S K EY T
SOLYMA	S AA L AH M AH
PLACKETS	P L AE K AH T S
THROWED	TH R OW D
UNPRUNED	AH N P R UW N D
DREAR	D R IH ER
HEADLANDS	HH EH D L AE N D Z
MOONSET	M UW N S EH T
ELDER'S	EH L D ER Z
VERGER	V ER JH ER
NOS	N OW Z
SHAG'S	SH AE G Z
JETTY'S	JH EH T IY Z
ECSTASIES	EH K S T AH S IY Z
CAMERA'D	K AE M R AH D
CONSTRAIN'D	K AH N S T R EY N D
KINSMEN	K IH N Z M EH N
UNWEARIED	AH N W IH R IY D
KICKIN	K IH K IH N
CHANTERELLES	CH AE N T AH R AH L Z
SESSHIN	S EH S AH N
TREE'S	T R IY Z
ROILS	R OY L Z
UNRIVALLED	AH N R AY V AH L D
CONTRIVING	K AH N T R AY V IH NG
NARDS	N AA R D Z
WAVELETS	W EY V L AH T S
CARPOOLING	K AA R P UW L IH NG
DARKENS	D AA R K AH N Z
ASHINE	AH SH AY N
CHEERIES	CH IH ER IY Z
EMOJI	AH M AA JH IY
MEOWS	M IY OW Z
CORNSTACKS	K AO R N S T AE K S
SIXPENCE	S IH K S AH N S
HEREYES	HH IY R EY Z
TAUPE	T AO P
WAFTS	W AA F T S
ARPROBUS	AA R P R AH B AH S
SOH	S OW
PORTIONING	P OW R SH AH N IH NG
SALLIED	S AE L IY D
ULTRAMARINE	AH L T R AH M AH R IY N
UNBROKE	AH N B R OW K
CESTON	S EH S T AH N
FINCH'S	F IH N CH IX Z
SNAPPER'S	S N AE P ER Z
TYRANT'S	T AY R AH N TS
SUNDOG	S AH N D AO G
OUZEL	AW Z AH L
EVENTIDE	IY V AH N T AY D
FISHBONE	F IH SH B OW N
BATTERY'S	B AE T ER IY Z
DUTY'S	D UW T IY Z
BR	B IY R
RAHERE	R AE HH AH R
KABIR	K AE B AH R
SODDENED	S AA D AH N D
COGNIZABLE	K AA G N AY Z AH B AH L
LORN	L AO R N
MARROWLESS	M AE R OW L AH S
DASTARD	D AE S T AH R D
DESERTEDNESS	D EH Z ER T AH D N AH S
MEMORIAL'S	M AH M AO R IY AH L Z
REJOICINGS	R IH JH OY S IH NG Z
FURROWS	F ER OW Z
LEADETH	L IY D IH TH
FERE	F IH R
OUTWALKED	AW T W AO K T
NARCISSI	N AA R S IH S IY
CHAPERONED	SH AE P AH R OW N D
DAUNTLESS	D AO N T L AH S
POSTCOLONIAL	P OW S T K AH L OW N IY AH L
PURSING	P ER S IH NG
TURNINGS	T ER N IH NG Z
FABRICATOR'S	F AE B R IH K EY T ER Z
OFTTIMES	AA F T AY M Z
BOATMEN	B OW T M EH N
SAY'ST	S EY S T
SLOGGIN	S L AA JH AH N
MALPIGLIO	M AE L P IH G L IY OW
COWSHED	K AW SH EH D
LANGEMARCK	L AE N JH AH M AH R K
GRAVING	G R EY V IH NG
CESTIUS	S EH S T AY AH S
MORNS	M AO R N Z
THAUMATURGY	TH AO M AH T AH R JH IY
ADJURING	AE JH Y AH R AH NG
ROWELED	R OW IY L D
MAYFLY	M EY F L AY
CARCANET	K AA R K AH N AH T
HAYROLL	HH EY R OW L
DECEAV'D	D AH S IY V D
WISTERIA	W IH S T IY R IY AH
NEGRA	N EH G R AH
SELFHOOD	S EH L F HH UH D
MOWER'S	M OW ER Z
FULBERT'S	F UH L B AH R T S
TABULAR	T AE B Y AH L ER
CORPORAL'S	K AO R P ER AH L Z
SANDFLIES	S AE N D F L AY Z
BLANKET'S	B L AE NG K AH TS
BOUTE	B OW Y UW T
YEARNETH	Y ER N IH TH
ETERNITY'S	IH T ER N AH T IY Z
CRKKKK	S IY AA R K EY K EY K EY K
PUCKERY	P AH K AH R IY
FOOTSTOOL	F UH T S T UW L
SULPHURIC	S AH L F ER IH K
BILLABONG	B IH L AH B AA NG
WATERDROPS	W AO T ER D R AA P S
MISCARRIED	M IH S K AE R IY D
O'ERSHROUDS	AA AH R SH R AW D Z
DECOY'S	D AH K OY Z
DERELICT'S	D EH R AH L IH K TS
DAPPLES	D AE P AH L Z
DOWNSHIFTS	D AW N SH IH F T S
SHELTERLESS	SH EH L T ER L AH S
NOR'WESTER	N AO R W EH S T AH R
DISTURB'D	D IH S T ER B D
FRAGMENTAL	F R AE G M AH N T AH L
SKINK	S K IH NG K
DANCT	D AE NG K T
YUKATTA	Y UW K AE T AH
OJIBWAYS	AH JH IH B W EY Z
QUINIE	K W IH N AY
HIGGELDIPIGGLEDY	HH IH JH EH L D AH P IH G L AH D IY
BANKRUPT'S	B AE NG K R AH P TS
YONGHY	Y AA N IY
TUI	T UW
RAVEN'S	R EY V AH N Z
FLOPPSIKON	F L AA P S AH K AH N
OTHERWORLD	AH DH ER W ER L D
SINGULARITIES	S IH NG G Y AH L AE R AH T IY Z
UNREMEMBERED	AH N R IH M EH M B ER D
IVRY	IH V R IY
WEAREST	W AE ER AH S T
BEAVER'S	B IY V ER Z
SANDFLY	S AE N D F L AY
SHAKUHACHI	SH AH K AH HH AH CH IY
SNIGGERED	S N IH G ER D
STREETLIGHTS	S T R IY T L AY T S
STREAMBANK	S T R IY M B AE NG K
DRAGONFLIES	D R AE G AH N F L AY Z
SAVIOUR	S EY V Y ER
FOONERAL	F UW N AH R AH L
READIN	R IY AH D IH N
SLURPED	S L ER P T
REPROVED	R IY P R UW V D
CURTSEYED	K ER T S IY D
TINYHISS	T AY N IY HH IH S
WEEN	W IY AH N
SWAINSON'S	S W EY N S AH N Z
HAUDINGE	HH AO D AH N JH
UNAVENGED	AH N AH V EH N JH D
ETYMOLOGIST	EH T AH M AA L AH JH AH S T
STORMLIGHT	S T AO R M L AY T
GORGON'S	G AO R G AH N Z
HAROUN	HH AH R AW N
PLANTLIFE	P L AE N T L AY F
NEEDLE'S	N IY D AH L Z
KULTUR	K AH L T AH R
GINKGO	G IH NG K OW
CORELLAS	K OW R AH L AE Z
TERRASSENGÄRTEN	T EH R AE S EH N G AA R T AH N
CUPYOUR	K Y UW P AY AH R
PAGEANTRIES	P AE JH AH N T R IY Z
CATTAIL	K AE T EY L
BREATHEST	B R IY DH AH S T
SITTETH	S IH T IH TH
CURDLING	K ER D L IH NG
CHURLIEST	CH AH R L AY AH S T
DROWSE	D R AW Z
VICTUALS	V IH T AH L Z
NUMBERLESS	N AH M B ER L AH S
ALMSHOUSE	AE L M SH AW Z
ILLA	IH L AH
CALYPHAS	K AE L AH F AH Z
TEASINGLY	T IY Z IH NG L IY
BILLOWY	B IH L OW IY
MARGALOTH	M AA R G AH L AH TH
EXQUISITENESS	EH K S K W IH Z AH T N AH S
OOM	UW M
ANTIENT	AE N T IY AH N T
CHINAWARE	CH IH N AH W EH R
TARSHISH	T AA R SH IH SH
RAGG'D	R AE G D
CUSAN	K Y UW Z AH N
UDDER	AH D AH R
SHADOW'S	SH AE D OW Z
ROSEETTI'S	R OW Z EH T IY Z
OLIMPIO	AH L IH M P IY OW
ORIENT'S	AO R IY EH N TS
LANGBRIDGE	L AE N G R AH JH
MINX	M IH NG K S
SWELLFOOT	S W EH L F UH T
DANDELION'S	D AE N D AH L AY AH N Z
UNTWISTED	AH N T W IH S T IH D
DINTED	D IH N T EH D
WHOE'ER	W OW AH AH R
TREMOLO	T R EH M AH L OW
MOLDERING	M OW L D ER IH NG
SURFETT	S AH R F AH T
FURROW'D	F ER OW D
SKITTERING	S K IH T ER IH NG
FRIGHTEN'D	F R AY T AH N D
OXENFORD	AA K S AH N F OW R D
FOREVERMORE	F AO R AH V AH R M AH R
COMMISERATED	K AH M IH Z ER EY T IH D
INSTR	IH N S T R
MANIKIN	M AE N IH K AH N
ORTHOPAEDIC	AO R TH AH P IY D AH K
AZAZIEL	AE Z AH Z IY L
ANITHER	AE N AH DH AH R
HAIRBALL	HH EH R B AO L
FIDN	F IH D N
CLOMB	K L AA M
COLORIST'S	K AH L ER IH S T S
SC	EH S K
PACKRAT	P AE K R AE T
DIMP	D IH M P
CARPET'S	K AA R P AH TS
FORETELLS	F OW R T EH L Z
OUTREACHING	AW T R IY CH IH NG
RESTAN	R EY Z T AE N
SPRIG	S P R IH G
OCEANUS	OW S IY N AH S
LATHERED	L AE DH ER D
GROUNDSMEN	G R AW N D Z M EH N
OUTSPREAD	AW T S P R EH D
LAMBENT	L AE M AH N T
CLOAKS	K L OW K S
FOGGED	F AA G D
RECORDARTE	R IH K AH R D AA R T
EVENSONG	IY V AH N S AO NG
LYSIUS	L IH S AY AH S
SCENNUM	S EH N AH M
SOURDOUGH	S AW ER D OW
OVERLIT	OW V ER L IH T
CONDENSES	K AH N D EH N S IH Z
HAPS	HH AE P S
NIGHTINGALE'S	N AY T IH NG G EY L Z
JOYLESS	JH OY L AH S
SHOWERY	SH OW AH R IY
SPEAK'ST	S P IY K S T
DIVIN	D IH V AH N
SPHAGNUM	S F AE G N AH M
PERSONAGE	P ER S AH N IH JH
SULIOTE	S UW L IY OW T
OWLET	OW L AH T
DARKEN'D	D AA R K AH N D
CANTERING	K AE N T ER IH NG
FRONTISPIECE	F R AH N T IY Z P IY S
COTH	K AA TH
GLISSANDOS	G L IH S AE N D AH Z
GECKO'S	G EH K OW Z
NORMANDE	N AO R M AH N D
SELFSAME	S EH L F S EY M
PETALLED	P EH T AH L D
AIRILY	EH R IY L IY
WOODSTOVE	W UH D S T OW V
WOLDE	W OW L D
DEAFENED	D EH F AH N D
YR	Y R
UPSWEAL	AH P S W IY L
BENTS	B IY AH N T S
SPEEDWELL	S P IY D W EH L
PURGANAX	P AH R G AH N AH K S
UNDRUNK	AH N D R AH NG K
VOYAGEURS	V W AA Y AA ZH ER Z
TUATARA	T Y UW AE T AH R AH
MISTRAL'S	M IH S T R AH L Z
FLUTIST'S	F L UW T IH S TS
SLAMMIN	S L AE M AH N
GRADER'S	G R EY D ER Z
TA'EN	T AE AH N
INGRESS	IH N G R EH S
SUNBURST	S AH N B ER S T
SARMATIA	S AA R M EY SH IY AH
PEEP'D	P IY P D
KLABOTERMAN	K L AE B AH T AH R M AH N
SNOWDUST	S N OW D AH S T
PIZZICATI	P IH Z IH K AH T IY
MAGUELONE	M AE G W AH L OW N
HD	EY CH D
PAWPRINTS	P AO P R IH N T S
DAMSELFLIES	D AE M Z AH L F L AY Z
GEMINIDS	JH EH M IH N AH D Z
SILLAGE	S IH L IH JH
HUMORS	HH Y UW M ER Z
GLUG	G L AH G
BASSWOOD	B EY S W UH D
REDEEMER	R IY D IY M ER
BORDS	B AO R D Z
SUMM'D	S AH M D
INTERR'D	IH N T EH R D
EYEHOLES	AY HH OW L Z
OVERPASSING	OW V ER P AE S IH NG
O'ERHEAD	AA AH R IY D
RECALIBRATING	R IY K AE L AH B R EY T IH NG
BROODS	B R UW D Z
NEBO'S	N EH B AH Z
CHINOOK'S	SH IH N UH K S
SHELLMOUND	SH EH L M AW N D
GAZILLION	G AH Z IH L IY AH N
TARENTUM	T AH R EH N T AH M
UNAPPRECIATIVE	AH N AH P R IY SH IY EY T IH V
FREEHOLDER'S	F R IY HH OW L D ER Z
UNFORGOTTEN	AH N F AO R G AA T AH N
PRENORMALIZATION	P R IY N AO R M AH L AH Z EY SH AH N
PLAINT	P L EY N T
ICTS	IH K T S
WATCHFULNESS	W AA CH F AH L N AH S
TUILERIES	T UW L AH R AY Z
STATIUS	S T AE T AY AH S
INKSTONE	IH NG K S T OW N
WATCHINGS	W AA CH IH NG Z
BLENT	B L EH N T
FLOWERLESS	F L AW ER L AH S
EXPREST	EH K S R AH S T
RAGWORT	R AE G W AH R T
FAME'S	F EY M Z
PURGATORIO	P AH R G AH T AO R IY OW
GRITTED	G R IH T IH D
BELISARIUS	B AH L AH S AE R AY AH S
THEREWITH	DH AE R W IH TH
ANJU	AE N JH UW
ATRIDES	AE T R AY D Z
SPANIEL'S	S P AE N Y AH L Z
MONSTER'S	M AA N S T ER Z
SANDALWOOD	S AE N D AH L W UH D
CANDLELIT	K AE N D AH L IH T
ETEXT	EH T AH K S T
WAXETH	W AE K S IH TH
CORNSHEAVES	K AO R N Z HH IY V Z
ANTIDOTES	AE N T IH D OW T S
SQUALLING	S K W AO L IH NG
ERSONATION	AH R S AH N EY SH AH N
HEEDFULLY	HH IY D F AH L IY
VALORI	V AE L AH R IY
LILYS	L IH L IY Z
TARTARY	T AA R T EH R IY
DOGDAY	D AO G D EY
AETHEREAL	AH IH TH IH R IY AH L
CANTABILE	K AE N T AH B AY L
REVALTIONS	R AH V AE L T IY AH N Z
SCUT	S K AH T
HAIKAI	HH EY K EY
PANDAR	P AE N D AH R
RETRIEVER'S	R IY T R IY V ER Z
IORA	AY AH R AH
BIGBANGS	B IH G B AE NG Z
WANDER'D	W AA N D ER D
RING'D	R IH NG D
ENDCAP	EH N D K AE P
ROUGING	R UW ZH IH NG
CABOOL	K AH B UW L
COMBUSTIBLES	K AH M B AH S T AH B AH L Z
KNIGHTLIER	N AY T L IY ER
UNDESIRED	AH N D IH Z AY ER D
WHITEBOARD	W AY T B OW R D
BLANCHED	B L AE N CH T
ACCURST	AE K AH R S T
SEPULCHRES	S EH P AH L K ER Z
REDTAIL	R EH D T EY L
REGROWTH	R IY G R OW TH
ROOSTER'S	R UW S T ER Z
SHOULDST	SH OW L D S T
MIZZEN	M IH Z AH N
KINSFOLK	K IH N Z F OW K
LOPING	L OW P IH NG
FEARE	F IY R
INACTION'S	IH N AE K SH AH N Z
BLEATING	B L IY T IH NG
LIV'D	L IH V D
BAPTIZES	B AE P T IH Z IH Z
SUSURRATION	S UW S AH R EY SH AH N
CLAMBERS	K L AE M B ER Z
SPHINXES	S F IH NG K S IH Z
UNDERTHINGS	AH N D ER TH IH NG Z
SHALOTT	SH AE L AH T
UNCLIMBED	AH N K L AY M D
SUBLIMER	S AH B L AY M ER
SNAG'S	S N AE G Z
BOUTONNI	B AW T AA N IY
TEPU	T EH P UW
SALMA'S	S AE L M AH Z
CUSHION'D	K UH SH AH N D
PAPERCLIP	P EY P ER K L IH P
CIGALE	S AH G EY L
GOBSMACKED	G AA B S M AE K T
DISHCLOTH	D IH SH K L AO TH
RENGA	R IH N G AA
WIDESCREEN	W AY D S K R IY N
CAFÉ	K AE F EY
RAJAH	R AA JH AH
FLAPAWAY	F L AE P AH W EY
PORTALAND	P OW R T AH L AE N D
CEUILLEUSE	S UW AH L UW Z
LEARN'D	L ER N D
MERMAIDEN	M ER M EY D AH N
O'ERCOMES	AA AH R K OW M Z
APOLLOS	AH P OW L AA S
BRIDALL	B R IH D AH L
DECOROUSLY	D EH K AH R AH S L IY
LONELIER	L OW N L IY ER
SIMMIAS	S IH M IY AH Z
WISPS	W IH S P S
TENTIE	T EH N T IY
COUNSELLING	K AW N S AH L IH NG
PURGATORIAL	P ER G AH T OW R IY AH L
ILLUME	IH L UW M
MICROSOFTIES	M AY K R OW S AO F T IY Z
AUTHORSHIPS	AO TH ER SH IH P S
EYESHADOWED	AY SH AE D OW D
MEAHTE	M IY T
AZA	AE Z AH
CUTTER'S	K AH T ER Z
LYCAEUS	L IH K IY AH S
LETTERBOX	L EH T ER B AA K S
STREWING	S T R UW AH NG
BELINZONA	B AH L IH N Z AH N AH
BODLEIAN	B OW D L IY IY AH N
FLOURY	F L AW ER IY
TEUTON	T Y UW T AH N
BUNTERS	B AH N T ER Z
NURSEMAIDS	N ER S M EY D Z
LANTERNLESS	L AE N T ER N L AH S
FORGAVEST	F AO R G EY V AH S T
WAXEST	W AE K S AH S T
BARWARE	B AA R W EH R
CHIAROSCURO	CH AY AH R AA S Y AH R OW
OD'D	AA D
LABYRINTHS	L AE B AH R IH N TH S
OBEY'ST	OW B EY S T
PARACHUTISTS	P AE R AH SH UW T IH S T S
CROTON	K R AA T AH N
LEARNING'S	L ER N IH NG Z
ALTHO	AE L TH OW
REVOLTER	R IH V OW L T ER
PARTERS	P AA R T ER Z
CLONKING	K L AO NG K AH NG
HAWSERS	HH AO Z ER Z
OSSIFYING	AA S AH F AY IH NG
MIZZLE	M IH Z AH L
MIME'S	M AY M Z
SWITCHBACK	S W IH CH B AE K
CHILION	CH IH L IY IY AH N
MEMORY'S	M EH M ER IY Z
GIPSY	JH IH P S IY
AMURATH	AE M Y AH R AH TH
BUFFLEHEAD	B AH F L AH HH IY D
BALLERINA'S	B AE L ER IY N AH Z
TIMBALLOO	T IH M B AE L UW
SWEETBOX	S W IY T B AA K S
UPCURLS	AH P K ER L Z
FREMDS	F R EH M D Z
HUNGA	HH AH N G AH
LAKE'SAFE	L AE K AH S EY F
HAIRDRESSER'S	HH EH R D R EH S ER Z
WEATHERWORN	W EH DH ER W OW R N
PHRENOLOGY	F R AH N AA L AH JH IY
NIFFELHEIM	N IH F AH L HH IY M
DESTRUCTIONS	D IH S T R AH K SH AH N Z
PAULM	P AO L M
SIEGENDORF	S IY JH EH N D AH R F
UNHUMAN	AH N HH Y UW M AH N
HEMLOCKS	HH EH M L AA K S
CRABAPPLES	K R AE B AE P AH L Z
SCEACEN	S IY AH S AH N
KNEELED	N IY L D
OPE	OW P
RESONANCES	R EH Z AH N AH N S IH Z
SUPERFINE	S UW P ER F AY N
WOODBURNING	W UH D B ER N IH NG
DEACON'S	D IY K AH N Z
WERKI	W AH R K IY
BIRDBATH	B ER D B AE TH
HOWE'ER	HH OW AH AH R
DAHLIAS	D AE L IY AH Z
SPINDLES	S P IH N D AH L Z
LAWN'S	L AO N Z
CENOTAPH	S EH N AH T AH F
EXTUINGUISHED	IH K S T UW N G W AH SH T
PINWHEELS	P IH N W IY L Z
CONMAN	K AH N M AE N
MUDDLER	M AH D AH L ER
CANENS	K EY N AH N Z
CLOWN'S	K L AW N Z
COMPAR	K AH M P AA R
SWOONS	S W UW N Z
GIAFFIR	JH AY AE F AH R
FAULTLESS	F AO L T L AH S
OSIRIS	AA S IY R IY Z
TREADLES	T R IY D AH L Z
FLAXEN	F L AE K S AH N
RECEIVETH	R IH S IY V IH TH
SKAFTING	S K AE F T AH NG
HANGING'S	HH AE NG IH NG Z
LATCHET	L AE CH AH T
RUNNEL	R AH N AH L
NURSERIE	N ER S ER IY
BARDS	B AA R D Z
DARKNESSES	D AA R K N AH S IH Z
GORGIO	G AO R JH IY OW
BIDETH	B AY D IH TH
VINOUS	V AY N AH S
HONORÉ	AA N ER EY
NECKLINES	N EH K L AY N Z
DESOLATION'S	D EH S AH L EY SH AH N Z
OPECHEE	AA P AH CH IY IY
CORPSE'S	K AO R P S IX Z
DIX'S	D IH K S IX Z
EXHALES	EH K S HH EY L Z
INTRENCHED	IH N T R EH N CH T
COLOURFUL	K AH L ER F AH L
LIGUSTRUM	L AH G AH S T R AH M
TIKKY	T IH K IY
GRAYBEARD'S	G R EY B IY R D Z
FIREFLY'S	F AY ER F L AY Z
MAENALUS	M IY N AH L AH S
IREFUL	AY ER F AH L
WATERPROOFS	W AO T ER P R UW F S
WHEREFROM	W AH R EH F R AH M
DISSATISFACTIONS	D IH S AE T AH S F AE K SH AH N Z
CROST	K R AA S T
TEARLESS	T IH ER L AH S
SOPHISTRIES	S AH F IH S T R AY Z
SCROOBIOUS	S K R UW B IY AH S
PONTIFFS	P AA N T AH F S
CRADLESONG	K R EY D AH L S AO NG
ABORD	AE B AH R D
DAYSPRINGS	D EY S P R IH NG Z
PREPOSITION	P R EH P AH Z IH SH AH N
DRAGOON	D R AH G UW N
CAP'N	K AE P N
SMITEST	S M AY T AH S T
UNDRIED	AH N D R AY D
SPEARMEN'S	S P IH ER M EH N Z
NEARNESS	N IH ER N AH S
COUREUR	K OW Y UH R AH R
FICUS	F AY K AH S
JACKSNIPES	JH AE K S N AY P S
CRICKETING	K R IH K AH T IH NG
PRAYER'S	P R EH R Z
VERNAGE	V AH R N AH JH
UNBARS	AH N B AA R Z
DIZZILY	D IH Z IY L IY
GLASSAS	G L AE S AH Z
INWARDS	IH N W ER D Z
DISENTANGLES	D IH S EH N T AE NG G AH L Z
RELENTS	R IH L EH N T S
TAMARACK'S	T AE M AH R AH K S
QUADRIGA	K W AA D R AH G AH
ALASTOR	AH L AE S T ER
REDGUM	R EH D G AH M
CIRCENSES	S AH R S EH N S AH Z
RYOKAN	R AY AH K AH N
REARRANGES	R IY AH R EY N JH IH Z
WIGEON	W IH JH AH N
UNCLICKS	AH N K L IH K S
BOSWELL'S	B AA Z W EH L Z
UNRIPE	AH N R AY P
SILVERFISH	S IH L V ER F IH SH
REVERY	R EH V AH R IY
CONTENTLY	K AH N T EH N T L IY
HENCEFORWARD	HH EH N S AH F AO R W AH R D
POLYPHEME	P AA L AH F IY M
INF	IH N F
PLENTY'S	P L EH N T IY Z
FLURIES	F L UW R IY Z
MENISCUS	M AH N IH S AH S
AGEING	EY JH IH NG
REDLY	R EH D L IY
SEAPLANE	S IY P L EY N
AIN	AH IH N
TEPEES	T IY P IY Z
MWNT	EH M D AH B AH L Y UW EH N T
STRAWMAN	S T R AO M AE N
SUBLIMITY	S AH B L AY M AH T IY
BAYBERRY	B EY B EH R IY
WEAR'ST	W IY R S T
RIMU	R IH M UW
RAINLESS	R EY N L AH S
SULLIES	S AH L IY Z
EDENHALL	AH D EH N HH AH L
ROOF'S	R UW F S
CRAIK	K R EY K
ROCKINGHORSE	R AA K IH NG HH AO R S
GRENADIERS	G R AH N EY D IY ER Z
POSITIONAL	P AH Z IH SH AH N AH L
UNRAVELLING	AH N R AE V AH L IH NG
MADRONA	M AE D R AH N AH
TOWPATH	T OW P AE TH
ORAZIO	AH R EY Z IY OW
DAMASCENE	D AE M AH S IY N
FLYS	F L AY Z
WATERLINE	W AO T ER L AY N
PROPHESY	P R AA F AH S AY
SPLATTING	S P L AE T AH NG
SHIPWRECKED	SH IH P R EH K T
SUPPER'S	S AH P ER Z
NEATENS	N IY T AH N Z
PERSISTANT	P ER S IH S T AH N T
WONS	W AH N Z
MOSQUITO'S	M AH S K IY T OW Z
YEASTY	Y IY S T IY
TRIFLERS	T R AY F AH L ER Z
WOODSTOVE'S	W UH D S T OW V Z
GOODLIER	G UH D L IY ER
COFFINMAKER	K AO F AH N M EY K ER
NKOMO	NG K AA M OW
PROCEEDETH	P R OW S IY D IH TH
ACRISIUS	AE K R IH S AY AH S
BEERCAN	B IH ER K AE N
STILLBORN'S	S T IH L B AO R N Z
BENISON	B IY AH N IY Z AO N
TETHERBALLS	T EH DH ER B AO L Z
RISETH	R AY Z IH TH
UNEATEN	AH N IY T AH N
MANZANAR	M AE N Z AH N AH R
VOTIVE	V OW T IH V
STREETLIGHT	S T R IY T L AY T
MAINSAIL	M EY N S EY L
RAINBURST	R EY N B ER S T
INSTRUCTOR'S	IH N S T R AH K T ER Z
HEIAN	HH IY IY AH N
MOONBOW	M UW N B AW
PRIMPED	P R IH M P T
MUFTI	M AH F T IY
METHINKS	M EH TH AH NG K S
PALMYRA	P AE L M AH R AH
CHATTANOOGAS	CH AE T AH N UW G AH Z
MALEDICTIONS	M AE L AH D IH K SH AH N Z
JACALA'S	JH AE K AH L AH Z
ALJAZEERA	AE L JH EY Z AH R AH
GE	JH IY
WATERSTRIDER'S	W AO T ER S T R AY D ER Z
GLEANER	G L IY N ER
YAHRZEIT	Y AE R Z IY T
GUNPORT	G AH N P OW R T
KM	K EY M
MAEVE'S	M AH EH V Z
CF	S IY F
EREWHILE	EH R UW AH L
ANNEMEEKEE	AE N AH M AH K IY IY
POSSUM'S	P AA S AH M Z
MARVELOUSNESS	M AA R V AH L AH S N AH S
WOODSMOKE	W UH D S M OW K
TASSELS	T AE S AH L Z
ABRIMAN	AE B R AH M AH N
XCVII	Z K V IY
NOSEPRINTS	N OW Z P R IH N T S
PENDANTS	P EH N D AH N T S
BOATSHED	B OW T SH EH D
HEATWAVES	HH IY T W EY V Z
PINCHES	P IH N CH IH Z
WATERPIPE	W AO T ER P AY P
BUMBLED	B AH M B AH L D
FIRMAMENT	F AH R M AH M AH N T
YEARLESS	Y IH ER L AH S
QUAILED	K W EY AH L D
SPLENDACIOUSLY	S P L EH N D AH S IY AH S L IY
PROVINCIALISMS	P R AH V IH N CH AH L IH Z AH M Z
TOILER	T OY L ER
SANCTITIE	S AE NG K T AH T AY
CONTAGIONS	K AH N T EY JH AH N Z
EREWHON	AH R UW HH AH N
LYSTE	L IH S T
WHEREAT	W IY R IY T
KUMQUATS	K AH M K W EY T S
INDECIPHERABLE	IH N D IY S AY F ER AH B AH L
MINESHAFT	M AY N SH AE F T
DAGUERREOTYPE	D AE G W EH R IY AH T AY P
GRINDEL	G R IH N D AH L
ALYSSUM	EY L IY Z S AH M
ICIER	AY S IY ER
TULLE	T UW L
PLUNG'D	P L AH N G D
PERCEIVABLE	P ER S IY V AH B AH L
DAYLILIES	D EY L IY L IY Z
BEAUTY'S	B Y UW T IY Z
REREADS	R IY R IY D Z
SOANSO'S	S OW N S AH Z
SQUARINGS	S K W EH R IH NG Z
DOPPELG	D AA P AH L G
SOLDERS	S AA D ER Z
KNELLED	N EH L D
MEETINGHOUSE	M IY T IH NG HH AW S
TRA	T R AA
SMOULDERING	S M OW L D IY R AH NG
TIAR	T AY ER
PHANTASTICAL	F AE N T AE S T IH S AH L
CLEW	K L UW
BAWLING	B AO L IH NG
TRUNK'S	T R AH NG K S
PUMPKIN'S	P AH M P K IH N Z
ZU	Z UW
ROADKILL'S	R OW D K IH L Z
PLAGIARISMS	P L EY JH AH R IH Z AH M Z
PROSTRATED	P R AA S T R EY T IH D
RHYMERS	R AY M ER Z
HEARTSTRINGS	HH AA R T S T R IH NG Z
ADORNER	AH D AO R N ER
SUTRA	S AH T R AH
KILLJOY'S	K IH L JH OY Z
FAIRINGS	F EH R IH NG Z
HELLION	HH EH L Y AH N
CRISIUM	K R IH S IY AH M
AWAKEIN	AH W EY K IH N
SLOTHFUL	S L OW TH F AH L
TITLING	T IH T L IH NG
MISLIKE	M IH S L AY K
TEMP'RATE	T EH M P R EY T
OPALS	AA P AH L Z
NAZARENE	N AE Z AH R IY N
UNTIN	AH N T IH N
GUSHIOUS	G AH SH IY AH S
UNALLIED	AH N AH L AY D
COURTYARD'S	K AO R T Y AA R D Z
SCOTERS	S K AA T ER Z
DISAPPOINTEDLY	D IH S AH P OY N T AH D L IY
HUSKED	HH AH S K T
SCINTILLAS	S IH N T IH L AH Z
HARMONICAS	HH AA R M AA N IH K AH Z
GOADS	G OW D Z
JAG	JH AE G
SATIE	S AE T IY
RIDENS	R AY D AH N Z
THRONED	TH R OW N D
DOVE'S	D AH V Z
LONGNECK	L AO NG N EH K
ZIDANE	Z AH D EY N
SHATTER'D	SH AE T ER D
WITHDRAW'ST	W IH TH D R AH S T
CEMPAN	S EH M P AH N
DOWSER'S	D AW Z ER Z
LOBELIA	L AH B IY L Y AH
FATHOMABLENESS	F AE DH AH M AH B AH L N AH S
NONAGENARIAN'S	N AH N AE JH AH N AE R IY AH N Z
SLAYS	S L EY Z
FAGOTS	F AE G AH T S
POISES	P OY Z IH Z
CALLIN	K AO L IH N
MATIN	M AE T AH N
EQUILATERAL	EH K W AH L AE T AH R AH L
REDEEMERS	R IY D IY M ER Z
UNSELFING	AH N S EH L F IH NG
COULD'ST	K OW AH L D S T
SEIG	S AY G
SUBMERGES	S AH B M ER JH IH Z
SPINDLY	S P IH N D AH L IY
SIBYL'S	S IH B AH L Z
CLONMACNOISE	K L AA N M AH K N OY Z
GREYNESS	G R EY N AH S
DRAGONFLY'S	D R AE G AH N F L AY Z
DORKING	D AO R K AH NG
SINNE'D	S IH N AH D
ATLANTUS	AE T L AE N T AH S
FOU	F UW
PERSIMMON	P ER S IH M AH N
YABBIES	Y AE B AY Z
BEELZEBUB	B AH EH L Z AH B AH B
FAMINE'S	F AE M AH N Z
CHURCHS	CH ER CH S
VAPOURS	V AH P OW Y AH R Z
SPARROWHAWK	S P AE R OW HH AO K
NUBS	N AH B Z
POEM'S	P OW AH M Z
GREBES	G R IY B Z
RAINBOW'S	R EY N B OW Z
KINFOLK	K IH N F OW K
ZAATAR	Z EY EY T AH R
ACHERON	EY K ER AO N
ARMSFUL	AA R M Z F AH L
BRAV'D	B R AE V D
UNWHOLESOME	AH N HH OW L S AH M
PALMING	P AA M IH NG
CURDLE	K ER D AH L
CAEDMON	K IY D M AH N
HERDSMAN	HH ER D Z M AE N
DOESN	D OW AH Z N
PUISSANT	P Y UW AH S AH N T
SMALSOR	S M AE L S AH R
HEMISPHERES	HH EH M AH S F IH ER Z
UNGLITTERING	AH N G L IH T ER IH NG
FEEBLER	F IY B AH L ER
EXTORTIONS	EH K S T AO R SH AH N Z
LYSIAS	L IH S IY AH Z
BEEING	B IY IH NG
LEONINE	L IY AH N AY N
FRIENDLESS	F R EH N D L AH S
IRIDESCE	IH R AH D EH S
PAULA'S	P AO L AH Z
IZNIK	IH Z N AH K
SHRINED	SH R AY N D
GUIDONS	G UW D AH N Z
COWRING	K OW R IH NG
KOZMIC	K AA Z M AH K
SOANE	S OW N
CHANGELESS	CH EY N JH L AH S
PALLBEARERS	P AO L B AE ER ER Z
MEGALITHIC	M EH G AH L AH TH AH K
GOOSEDOWN	G UW S D AW N
EPIMETHEUS	EH P AH M EH DH IY AH S
COLORIST	K AH L ER IH S T
EWE'S	Y UW Z
CLOTHESPIN	K L OW DH S P IH N
TWILIT	T W IH L AH T
SHINNING	SH IH N IH NG
JEWELLED	JH UW AH L D
WATERDROP	W AO T ER D R AA P
ROVIN	R AA V AH N
GRANITA	G R AE N AH T AH
FETLOCKS	F EH T L AH K S
STUTTERED	S T AH T IY R D
THUNDERCLAPS	TH AH N D ER K L AE P S
SLEPES	S L IY P S
FOCUSSING	F OW K AH S IH NG
BACINICA	B AH S IH N AH K AH
BAULK	B AO K
PENALTIE	P IY N AH L T AY
UNSEEABLE	AH N S IY AH B AH L
PARADERS	P AH R EY D ER Z
MONNA	M AA N AH
APPLEWOOD	AE P AH L W UH D
BLASPHEMIES	B L AE S F AH M IY Z
AUSTERITIES	AO S T EH R AH T IY Z
OFFENCES	AH F EH N S IH Z
FAULTLINE	F AO L T L AY N
IWE	IH W
WEEPETH	W IY P IH TH
SEABIRD	S IY B ER D
BOUNDEN	B AW N D AH N
LOCKSLEY	L AA K S L IY
O'PHACE	AA F AH S
SLEEP'ST	S L IY P S T
PAEKAKARIKI	P IY K AH K AE R AH K IY
SALVIATI	S AE L V IY AH T IY
TINK	T IH NG K
WAKENS	W EY K AH N Z
WHA	W AA
GEATAS	JH IY T AH Z
HITCHENER	HH IH CH AH N ER
HIM'S	HH IH M Z
DEMIGOD'S	D AH M IH G AH D Z
BARNLIKE	B AA R N L AY K
FUCHSIA	F Y UW SH AH
EXPIATION	EH K S P IY EY SH AH N
ROOK'S	R UH K S
GUNWALE	G AH N W EY L
BARDIC	B AA R D IH K
TUMBLEWEED	T AH M B AH L W IY D
ENLIGHTMENT	EH N L AY T M AH N T
ALARUMS	AE L AH R AH M Z
COCK'S	K AA K S
KISSABLE	K IH S AH B AH L
BATHWATER	B AE TH W AO T ER
PIROUETTING	P AY R AH W EH T IH NG
PROVIDENTIALLY	P R AA V AH D EH N CH AH L IY
BODYBUILDER	B AA D IY B IH L D ER
PHANTOMWISE	F AE N T AH M W AY Z
THRACE	TH R EY S
ULU	Y UW L UW
FUNNYS	F AH N IY Z
WAST	W AA S T
INTERSTICES	IH N T ER S T AH S IH Z
UNSAY	AH N S EY
MARMOT	M AA R M AH T
CASSIUS	K AE S AY AH S
SIBYLLINE	S IH B AH L AY N
EARING	IH ER IH NG
SHYLOCK'S	SH AY L AA K S
MIGRATORS	M AY G R AH T ER Z
TENDEST	T EH N D AH S T
LUNEL	L UW N AH L
CLOYED	K L OY D
CAF	K AE F
INCLOSING	IH N K L OW Z IH NG
ROTOTILLER'S	R OW T AH T IH L ER Z
TIDEPOOL	T AY D P UW L
JINGLY	JH IH NG G AH L IY
BLUEJAYS	B L UW JH EY Z
ALRASCHID	AE L R AE S AH D
STUMP'S	S T AH M P S
TAILLESS	T EY L AH S
SEMICIRCLE	S EH M IY S ER K AH L
UNBLINKING	AH N B L IH NG K IH NG
NOONING	N UW N IH NG
EMASCULATES	IH M AE S K Y AH L EY T S
GARGLE	G AA R G AH L
IMPERILLING	IH M P EH R AH L IH NG
FREIGHTED	F R EY T IH D
CHURLS	CH AH R L Z
EX'S	EH K S IX Z
SPHINXED	S F IH NG K S T
LEAFPILE	L IY F P AY L
FLICKED	F L IH K T
NEEDETH	N IY D IH TH
PERSIMMONS	P ER S IH M AH N Z
THATT	TH AE T
DESPIGHT	D IH S AY T
NEBULAE	N EH B Y AH L IY
CONJECTURED	K AH N JH EH K CH ER D
ELLIPTIC	IH L IH P T IH K
FLOES	F L OW Z
REIGNEST	R EY N AH S T
PORTAGOOSE	P OW R T AH G UW S
ENTHEOGEN	IH N TH IY AH JH AH N
FURZE	F AH R Z
WHERE'ER	W EH R AH AH R
LUCRE	L UW K AH R
NIGHTGOWN	N AY T G AW N
BABAI	B AE B EY
NEOSHO	N IY AH SH OW
PEEPERS	P IY P ER Z
DISCOLOURED	D IH S K AH L ER D
PREPOS	P R EH P AA S
CLARE'S	K L EH R Z
TAUNTINGS	T AO N T IH NG Z
UNKNOT	AH N AA T
FIREWORK'S	F AY R W ER K S
PETASIDE	P EH T AH S AY D
SCRUBS	S K R AH B Z
TOGAS	T AA G AH Z
CHICKADEE	CH IH K EY D IY
NAIAD	N EY AH D
UNCLOTHE	AH N K L OW DH
CHAPPED	CH AE P T
CERULEAN	S AH R UW L IY AH N
MEWS	M Y UW Z
RANGITOTO'S	R AE N JH IH T AH T AH Z
INDISTINCTLY	IH N D IH S T IH NG K T L IY
CORELLI	K OW R AH L IY
BR'ER	B R EH R
RIVE	R AY V
DEJ	D EH JH
RESETTING	R IY S EH T IH NG
JARLS	JH AA R L Z
KONTRYM	K AA N T R AH M
CHUSED	CH UW Z D
REDE	R AH D IY
MAURIER	M AO R AY AH R
LIMPERS	L IH M P ER Z
PROFANATIONS	P R OW F EY N EY SH AH N Z
IAMBS	AY AH M Z
CHANTINGS	CH AE N T IH NG Z
NEIST	N IY AH S T
EDAMAME	EH D AH M EY M
DIMNESS	D IH M N AH S
BELLED	B EH L D
SPEARED	S P IH ER D
FATHOMLESS	F AE DH AH M L AH S
FINGERLINGS	F IH NG G ER L IH NG Z
AHKOOND	AH K UW N D
UNPLEATS	AH N P L IY T S
EUPHORIA'S	Y UW F AO R IY AH Z
FLITTERS	F L IH T ER Z
COMELINESS	K AH M L IY N AH S
ALOES	AE L OW Z
FAINTS	F EY N T S
POESY	P OW AH Z IY
SYNCOPATES	S IH NG K AH P EY T S
RUFOUS	R UW F AH S
WRISTBAND	R IH S T B AE N D
THOU'LT	TH AW L T
FULNESS	F UH L N AH S
IND	AY N D
TINGLED	T IH NG G AH L D
SOBA	S OW B AH
CHASMS	K AE Z AH M Z
RUSTLES	R AH S AH L Z
TYRWHITT'S	T AH R W HH AH T S
FILMY	F IH L M IY
ZAPPER	Z AE P AH R
FUMAROLE	F Y UW M AH R OW L
SEPULCHRAL	S EH P AH L K ER AH L
SLEEPLESNESS	S L IY P L EH Z N AH S
REPTILE'S	R EH P T AY L Z
PICKAXE	P IH K AE K S
SYSTEMIZE	S IH S T AH M AY Z
CHINASKI	CH AY N AH S K IY
WIELDEST	W IY L D AH S T
IRAE	IH R IY
NOONDAY	N UW N D EY
MYR	M IH R
PARAMOUR	P AE R AH M AH R
PROMPTER'S	P R AA M P T ER Z
DULLS	D AH L Z
WETHER	W EH DH ER
CALIRIOTES	K AH L IH R IY OW T S
PINIONS	P IH N Y AH N Z
GOMARA	G AA M AH R AH
LIDLESS	L IH D L AH S
INVISIBLY	IH N V IH Z AH B L IY
SINGETH	S IH N JH IH TH
GEISENHEIM	JH IY S AH N HH IY M
HIGHWAYMAN	HH AY W EY M AE N
TRANSITIVE	T R AE N Z AH T IH V
WAITANGI	W EY T AE N JH IY
ALBION'S	AE L B IY AH N Z
NONSENSIQUES	N AA N S EH N S AH K S
PANIA	P EY N Y AH
HERBAGE	ER B IH JH
UNTWISTING	AH N T W IH S T IH NG
MISO	M AH S OW
ROSHI	R AA SH IY
HATCHLING	HH AE CH L IH NG
COTTINGTON	K AA T IH NG T AH N
PARESIS	P EH R Z IY Z
FRIDGIDAIRE	F R IH JH IH D AH AH R
ENGLISHNESS	IH N G L IH SH N AH S
JAVELINS	JH AE V AH L AH N Z
SADDUCEE	S AE D Y AH S IY IY
MANAHEM	M AA N AH HH EH M
INSTILS	IH N S T AH L Z
INGOMAR	IH N G OW M AA R
JONQUILS	JH AA N K W AH L Z
MASSICOTÉ	M AE S AH K AH T EY
CANTED	K AE N T IH D
WINDSOCK	W IH N D S AA K
SOUTHEY	S AW TH IY
HIJAB	HH IH JH AH B
FLOATPLANE	F L OW T P L EY N
ARSENICAL	AA R S N IH K AH L
AVENGES	AH V EH N JH IH Z
VIOLET'S	V AY AH L IH TS
WHIRLIGIG	W AH R L AH JH AH G
SUBORN'D	S AH B AO R N D
LANGUOR	L AE N G W AH R
RELIQUERY	R AH L AH K EH R IY
DRONTHEIM	D R AA N TH IY M
SOUNDPROOF	S AW N D P R UW F
TWELVEMONTHS	T W EH L V M AH N TH S
CORMORANT'S	K AO R M ER AH N TS
LARK'S	L AA R K S
CHIDDEN	CH IH D AH N
PITIEST	P IH T IY AH S T
UNBLAMED	AH N B L EY M D
ENTANTS	IH N T AE N T S
UNFADING	AH N F EY D IH NG
CES	S
WAW	W AO
UNQUENCHED	AH N K W EH N CH T
PERCALE	P AH R K EY L
FLINCHES	F L IH N CH IH Z
SANDCRAB	S AE N D K R AE B
GAZEST	G EY Z AH S T
ECG	EH K G
DAREN'T	D EH R AH N T
CHAIR'S	CH EH R Z
KINDERGARTENERS	K IH N D ER G AA R T AH N ER Z
BEHOOF	B IH HH UW F
DUPERRIER	D UW P ER R IY ER
STOOP'D	S T UW P D
HALED	HH EY L D
ROSEHIPS	R OW Z HH IH P S
ICESNOW	AY S N OW
EAGLED	IY G AH L D
WHATTEN	W AA T AH N
RHUYS	R UW W AH Z
PURPOSING	P ER P AH S IH NG
SHOSTAKOVITCH	SH AA S T AE K AH V AH CH
LAUGH'D	L AE F D
HALFRED	HH AE F R EH D
WADDLES	W AA D AH L Z
SWERVES	S W ER V Z
TARTARIAN	T AA R T EH R IY AH N
AGADIRS	AE G AH D AH R Z
RECLIN'D	R IH K L IH N D
MESSALINA	M EH S AE L AH N AH
FILL'D	F IH L D
REDWING'S	R EH D W IH NG Z
COMPA	K AA M P AA
DRONTHEIM'S	D R AA N TH IY M Z
ALPHABETS	AE L F AH B EH T S
AULDER	AO L D AH R
SHAKIN	SH AE K AH N
EA	IY AH
MARAZION	M AH R EY Z IY AH N
PLIGRIMAGE	P L IH G R AH M AH JH
WAND'RINGS	W AA N D R IH NG Z
FAILINGLY	F EY L IH NG L IY
SWALLOWTAIL	S W AA L OW T EY L
DIVINEST	D AH V AY N AH S T
FEROOD	F AH R UW D
WICK'S	W IH K S
CONCHO	K AA N CH OW
TRUSLOVE	T R AH Z L OW V
MAZATLAN	M AH Z AE T L AH N
FRANGIEH	F R AE N JH AY
WASTELANDS	W EY S T L AE N D Z
PLODDINGS	P L AA D IH NG Z
SONGBIRD'S	S AO NG B ER D Z
OVERPASSED	OW V ER P AE S T
NOKOMIS	N AA K AH M AH S
WELLNIGH	W EH L N AY
HALLOWE	HH AO L OW
ENLIGHT'NING	IH N L AY T N AH NG
XIIIIT	Z IY IY T
SUGARBOWL	SH UH G ER B OW L
HADST	HH AE D S T
GLOOMING	G L UW M IH NG
LRMT	EH L AA R EH M T
VESPERS	V EH S AH R Z
GERFALCON'S	JH AH R F AE L K AH N Z
DAPPLE	D AE P AH L
RECEIV'D	R AH S IY V D
MONODY	M AA N AH D IY
COMMISSURE	K AH M IH SH ER
OUTMOST	AW T M OW S T
UNREGARDED	AH N R IH G AA R D IH D
LOUNGER	L AW N JH ER
RUSTUM	R AH S T AH M
STREAMLETS	S T R IY M L AH T S
SOMBRE	S AA M B ER
JACARANDA	JH AE K AH R AE N D AH
TRESPASSES	T R EH S P AH S IH Z
PICKER'S	P IH K ER Z
BLOODWORK	B L AH D W ER K
PATHAN'S	P AE TH AH N Z
HEARTSICK	HH AA R T S IH K
KNEWEST	N UW AH S T
ADDENDA	AE D EH N D AH
MOORHEN	M UH R HH EH N
HECATE	HH IY K EY T
BO'SUN	B AA S AH N
STRAGGLES	S T R AE G AH L Z
DEID	D IY IH D
ENFOLDETH	EH N F OW L D IH TH
STRIVEST	S T R AY V AH S T
HALAL	HH EY L AH L
RESPLENDENTLY	R IY S P L EH N D AH N T L IY
PURENESS	P Y UH R N AH S
WOODFIRE	W UH D F AY ER
AUTUMNS	AO T AH M Z
GUDRUN	G AH D R AH N
INTACTNESS	IH N T AE K T N AH S
TANNINS	T AE N AH N Z
PRESUM'D	P R IY S AH M D
ENDLESSNESS	EH N D L AH S N AH S
NETHERMOST	N EH DH ER M OW S T
GOETH	G OW IH TH
ABSTRACTEDLYONE	AE B S T R AH K T EH D L AY OW N
CROUCHES	K R AW CH IH Z
SACAGAWEA'S	S AH K AE G AH IY Z
SG	EH S G
UNTRODDEN	AH N T R AA D AH N
BESTEAD	B IH S T EH D
MATCH'D	M AE CH D
REBUILDED	R IY B IH L D IH D
ZONORAS	Z AA N AH R AH Z
WAHONOWIN	W AH HH AA N OW AH N
ZAR	Z AA R
REPOSED	R IY P OW Z D
COMFORTINGS	K AH M F ER T IH NG Z
STALWORTH	S T AE L W AH R TH
ARCADY	AA R K EY D IY
REMOVESTRAW	R IY M UW V S T R AO
ANNULLING	AE N AH L AH NG
TR	T IY R
MANY'S	M EH N IY Z
VICTORIOUSLY	V IH K T OW R IY AH S L IY
SHORELESS	SH OW R L AH S
BLACKTHORN	B L AE K TH AO R N
ANAH	AE N AH
UNMAPPED	AH N M AE P T
UNLEARN	AH N L ER N
LEADLIGHT	L IY D L AY T
SIRED	S AY ER D
MATTED	M AE T IH D
UNPICKED	AH N P IH K T
HAIJIN'S	HH EY JH AH N Z
HANOUT	HH AH N AW T
ELION	IY L IY AH N
SINEWS	S IH N Y UW Z
ORIENTING	OW R IY EH N T IH NG
MIKEY'S	M AY K IY Z
BAREBACK	B EH R B AE K
INDENTATIONS	IH N D EH N T EY SH AH N Z
CUSTOME	K AH S T OW M
SCIMITAR	S IH M AH T ER
CAERNARFON	K IY R N AA R F AH N
STAMMERS	S T AE M ER Z
SUNCATCHER	S AH N K AE CH ER
CORDITE	K AA R D AY T
MYSTIFICATION	M IH S T AH F AH K EY SH AH N
EPIPHYTES	EH P AH F AY T S
FENCELINE	F EH N S L AY N
UNWEPT	AH N W EH P T
SPADEFULS	S P EY D F AH L Z
HOARFROSTED	HH OW ER F R AO S T IH D
CADDIS	K AE D IY Z
THET'S	TH EH T S
SANDRA'S	S AE N D R AH Z
ROOVES	R UW V Z
ENCHANTS	EH N CH AE N T S
TINGLES	T IH NG G AH L Z
SPANGLY	S P AE NG G AH L IY
CLIFFSIDE	K L IH F S AY D
SMITE	S M AY T
BYFORNE	B IH F AH R N
MOTHERED	M AH DH ER D
SISKINS	S IY Z K IH N Z
KHAMSIN	K HH AE M Z AH N
YOICKS	Y OY K S
SKIE	S K AY
MAGDEBOURG	M AE G D AH B OW R G
MUDFLATS	M AH D F L AE T S
OMG	AA M G
XX	EH K S Z
EDDYING	EH D IY IH NG
HANDMAIDENS	HH AE N D M EY D AH N Z
TEREU	T IY R UW
SKYFUL	S K AY F AH L
FOXGLOVES	F AA K S G L AH V Z
BRANCHHE	B R AE NG K
DEADFALL	D EH D F AO L
UNMEASURED	AH N M EH ZH ER D
UGUDWASH	Y UW G AH D W AH SH
LEPRONE	L EH P R OW N
ENKINDLES	EH N K IH N D AH L Z
UNLOOPS	AH N L UW P S
INAMORATAS	AH N AH M AO R AH T AH Z
EARTHWARD	ER TH W ER D
HOUSEWIFE'S	HH AW S W AY F S
LARA'S	L AA R AH Z
CANOE'S	K AH N UW Z
BOSOMS	B UH Z AH M Z
COTTONTAIL	K AA T AH N T EY L
COWPAT	K AW P AE T
SUTTIN	S AH T AH N
UNCLOSED	AH N K L OW Z D
PANOPTICON	P AE N AA P T IH K AO N
GANGWAY	G AE NG W EY
HOARFROST	HH OW ER F R AO S T
GIRDLED	G ER D AH L D
SAPLING'S	S AE P L IH NG Z
ASHBERY	AE SH B IY AH R IY
MOONLESS	M UW N L AH S
TOHOKU	T AA HH AH K UW
YPRES	Y P AH R Z
WINDINGS	W IH N D IH NG Z
CASSINO'S	K AH S IY N OW Z
GREENGROCER	G R IY N G R OW S ER
HEARTSTRUCK	HH AA R T S T R AH K
HIE	HH AY
FUMATORIUM	F Y UW M AH T AO R IY AH M
WHELK	W EH K
ONIAS	OW N Y AH Z
HOOPED	HH UW P T
IMAGININGS	IH M AE JH AH N IH NG Z
AUGURY	AO G ER IY
LOVELIER	L AH V L IY ER
NEATH	N IY TH
UNFORCED	AH N F OW R S T
HEADLAMPS	HH EH D L AE M P S
UNFAITHFULNESS	AH N F EY TH F AH L N AH S
SOUNDETH	S AW N D IH TH
COUNCILLORS	K AW N S AH L ER Z
TITYRUS	T IH T AH R AH S
AMBIT	AE M B AH T
UNDISSUADED	AH N D IH S W EY D IH D
ATHIRST	AH TH ER S T
EXTEMPORISE	EH K S T EH M P OW R AY Z
LABRADOR'S	L AE B R AH D AO R Z
FEORUM	F IY AH R AH M
MCDO	M K D OW
TRILLS	T R IH L Z
COOINGS	K UW IH NG Z
RETIR'D	R AH T IH R D
FREMONT'S	F R IY M AA N TS
UNSEASONABLE	AH N S IY Z AH N AH B AH L
HILLBREEZE	HH IH L B R IY Z
LUNATION	L UW N EY SH AH N
OO	UW
ARDENNES	AA R D AH N Z
PAPERWHITES	P EY P ER W AY T S
CONSUMERISM'S	K AH N S UW M ER IH Z AH M Z
CONSECRATING	K AA N S AH K R EY T IH NG
TYPHOEAN	T AH F OW AH AH N
PONY'S	P OW N IY Z
QUIV'RING	K W IH V R AH NG
PERSEIDS	P AH R S AY D Z
ENFOLDS	EH N F OW L D Z
MODIGLIANI'S	M OW D IH G L IY AA N IY Z
THYRI	TH IH R IY
SWEETPEAS	S W IY T P IY Z
HOBOMOK	HH AA B AH M AH K
HURTLED	HH ER T AH L D
LAUNDRY'S	L AO N D R IY Z
JUDAH'S	JH UW D AH Z
ND	EH N D
MALLEE	M AE L IY IY
PMB	P IY EH M B
PRESS'D	P R EH S D
MUDDEN	M AH D AH N
CONFIRMETH	K AH N F ER M IH TH
GLIDER'S	G L AY D ER Z
ACUMINATA	AE K Y AH M IH N AH T AH
CHIVE	CH AY V
UNMINDFUL	AH N M AY N D F AH L
URINAL'S	Y UH R AH N AH L Z
CROOKING	K R UH K IH NG
BLACKMOUTH'S	B L AE K M AW TH S
VALOROUS	V AE L ER AH S
PARASOLS	P AE R AH S AO L Z
NEPHELIDIA	N EH F AH L IH D IY AH
SIDEWARD	S AY D W ER D
REND	R EH N D
XXII	Z K S IY
FARAN	F AE R AH N
CONTUMELY	K AA N T Y UW M L IY
TATOO	T AE T UW
UNCAGED	AH N K EY JH D
MILLWALL	M IH L W AO L
HUESO'S	HH Y UW AH S AH Z
WITHER'D	W IH DH ER D
WIGWAMS	W IH G W AH M Z
UNBIND	AH N B AY N D
FLUFFING	F L AH F IH NG
SENIOR'S	S IY N Y ER Z
BACCHANT'S	B AE K AH N T S
EIDERDOWN	IY D AH R D OW N
VACATION'S	V EY K EY SH AH N Z
ORBED	AO R B D
LOVELIES	L AH V L IY Z
LIVST	L IH V S T
SAW'ST	S AO S T
BULB'S	B AH L B Z
FLUTED	F L UW T IH D
UNTROD	AH N T R AA D
DIAN'S	D AY AH N Z
SANCTIFIED	S AE NG K T AH F AY D
LOUNGEWEAR	L AW N JH W AE ER
SLATY	S L EY T IY
ORIOLE'S	AO R IY OW L Z
HEAD'D	HH EH D
KIDDO	K IH D UW
SCHOOLGIRL'S	S K UW L G ER L Z
WILLOW'S	W IH L OW Z
SNAFFLE	S N AE F AH L
WAXWINGS	W AE K S W IH NG Z
WHIRR	W AH R
BOUILLONNE	B AW IH L AH N
SONGLESS	S AO NG L AH S
PENSIONED	P EH N CH AH N D
PORTRAITURES	P OW R T R AH CH ER Z
INLY	IH N L IY
PIGTAILS	P IH G T EY L Z
BIRCHES	B ER CH IH Z
FIRETHORN	F AY ER TH AO R N
APPLEMINT	AE P AH L M IH N T
SHOULDA	SH OW L D AH
GRAINFIELD	G R EY N F IY L D
PANTLEGS	P AE N T L EH G Z
CHAMPING	CH AE M P IH NG
STEELE'S	S T IY L Z
SPINNAKERS	S P IH N AH K AH R Z
PRETENCE	P R IY T EH N S
SUPPLICATIONS	S AH P L AH K EY SH AH N Z
PALSIED	P AO L Z IY D
EVENINGWINDS	IY V N IH NG W IH N D Z
CROSSBEAM	K R AO S B IY M
ORANGER	AO R IH N JH ER
DOZY	D OW Z IY
FLANG	F L AE NG
BLEAT	B L IY T
RINGTONE	R IH NG T OW N
COURTESAN	K OW R T AH S AH N
KNEADED	N IY D IH D
CREEKSIDE	K R IY K S AY D
WINGTIP	W IH NG T IH P
VEINED	V EY N D
BITTERER	B IH T ER ER
SHOREBIRD'S	SH AO R B ER D Z
TEABAG	T IY B AE G
CHERSONESE	CH AH R S AH N IY Z
LICHTENIN	L IH CH T AH N AH N
SHIRTLESS	SH ER T L AH S
KEENING	K IY N IH NG
DOESNT	D OW AH Z N T
MOLE'S	M OW L Z
CONTRE	K AA N T AH R
UPWIND	AH P W IH N D
TORCHLIGHT	T AO R CH L AY T
SEEWHERE	S IY W HH AH R
DISSEMBLED	D IH S EH M B AH L D
WOPPED	W AA P T
SKEDADDLED	S K EH D AH D AH L D
DIONYSUS	D AY AA N AH Z AH S
MARGINALIA	M AA R JH AH N EY L Y AH
SWEETFISH	S W IY T F IH SH
NASTURTIUMS	N AE S T AH R T IY AH M Z
MEADOWLARKS	M EH D OW L AA R K S
EPIGRAMS	EH P AH G R AE M Z
ISOBAR	IH S AH B AH R
CRAQUE	K R AE K
SWINEHOOD	S W AY N HH UH D
ORBE	AO R B
GEEZERS	JH IY Z AH R Z
EVEY	IY V IY
PELEUS	P IY L IY AH S
TOMCAT'S	T AA M K AE TS
UNDRESSING	AH N D R EH S IH NG
VENTOUX	V EH N T AW K S
BROMELIAD	B R AH M IY L IY AH D
MURDERESS	M ER D ER AH S
HUZZAS	HH AH Z AH Z
SUABIAN	S W EY B IY AH N
ORPHAN'S	AO R F AH N Z
VOW'D	V AW D
PEBBLY	P EH B AH L IY
EFFIGIES	EH F AH JH AY Z
CLIMATE'S	K L AY M AH TS
PALINGENESIS	P AE L IH N JH EH N AH S AH S
SNOWLIGHT	S N OW L AY T
TRAFIC	T R AE F AH K
INCHWORM	IH N CH W ER M
UNMOURNED	AH N M OW R N D
SECRETES	S IH K R IY T S
MOTH'S	M AO TH S
KATYDIDS	K AE T AH D AH D Z
DRUNKARD'S	D R AH NG K ER D Z
SULI'S	S UW L AH Z
SNOWPACK	S N OW P AE K
REPATCHED	R IY P AE CH T
CATCOTT'S	K AE T AH T S
SOLCHE	S OW L CH
EUMENIDES	Y UW M AH N AY D Z
ALONEST	AH L OW N AH S T
PRYTHEE	P R AY TH IY
PLEASURED	P L EH ZH ER D
WESER	W IY Z ER
UNMEET	AH N M IY T
WILDERED	W AY L D ER D
DOJO	D OW JH OW
MAJALES	M AH JH EY L Z
ASHGLORY	AE SH G L OW R IY
COMMONEST	K AA M AH N AH S T
TRAMWAYS	T R AE M W EY Z
PINECONE	P AY N K OW N
YABBOK	Y AE B AH K
D'EXISTER	D EH K S IH S T AH R
UNEARTHS	AH N ER TH S
CONCENTERED	K AH N S EH N T ER D
REVENG'D	R AH V EH N G D
UNVALUED	AH N V AE L Y UW D
PUTAIN	P UH T AH IH N
PUDDLED	P AH D AH L D
FADO	F AE D OW
IDENTITY'S	AY D EH N T AH T IY Z
WHOSO	W AA S OW
INSTEP	IH N S T EH P
IMPURER	IH M P Y UH R ER
WATERFALL'S	W AO T ER F AO L Z
GRECIANS	G R IY SH AH N Z
QUADRO	K W AA D R OW
INTERLACING	IH N T ER L EY S IH NG
BURRS	B ER Z
SUPPERTIME	S AH P ER T AY M
ERYMANTHUS	EH R AH M AE N TH AH S
LYT	L IH T
SURREALIST	S AH R IY AH L AH S T
REJOYCE	R AH JH OY S
BELLEFONTAINE	B IH L EH F AH N T EY N
BERTHED	B ER TH T
VEXATION	V EH K S EY SH AH N
SENCELESSE	S EH N S AH L AH S
SHUSH	SH AH SH
MERTH	M AH R TH
PICT	P IH K T
MISTFALL	M IH S T F AO L
KNAPSACKS	N AE P S AH K S
PINEWOOD	P AY N W UH D
WHILOM	W IH L AH M
AWOKEN	AH W OW K AH N
DAMSELFLY	D AE M Z AH L F L AY
TENOUR	T EH N AH R
ROSEBUDS	R OW Z B AH D Z
RUDBORNE	R AH D AH R N
ALLOPATHIC	AE L AH P AH TH AH K
JURRASSIC	JH AH R AH S AH K
SANDPIPERS	S AE N D P AY P ER Z
PICKUP'S	P IH K AH P S
CANEA	K EY N IY AH
CHATTERS	CH AE T ER Z
WRINGS	R IH NG Z
XXVI	Z K S V IY
ALLWAYS	AO L W EY Z
CONTRAIL	K AH N T R EY L
PRIVILY	P R IH V IY L IY
UNCURLING	AH N K ER L IH NG
MUSCOVY	M AH S AH V IY
BOSSOM	B AA S AH M
IS'T	IH S T
DENOUEMENTS	D EY N UW M AA N Z
STRAFFORD	S T R AE F AH R D
HENTLY	HH EH N T L IY
DAIMYO'S	D EY M AY AH Z
WATERLILIES	W AO T ER L IY L IY Z
CLOUDRACK	K L AW D R AE K
ESQ	EH S
DISPERSES	D IH S P ER S IH Z
TAGGY	T AE G IY
TANAGER	T AE N IH JH ER
SNUGNESS	S N AH G N AH S
BEACHSTORE	B IY CH S T OW R
GRANULATED	G R AE N Y UW L EY T IH D
SHUH	SH UW
TOPER	T AA P ER
BENIGNANT	B IH N AY N AH N T
BROOKLET	B R UH K L AH T
VICTUMS	V IH K T AH M Z
UNWINDS	AH N W IH N D Z
SNOWDON'S	S N OW D AH N Z
SQUIRREL'S	S K W ER AH L Z
O'ERFLOWING	AH AH R F L OW AH NG
TEMPEST'S	T EH M P AH S TS
MUNGART	M AH N G AH R T
SNOWINGAND	S N OW IH N G AH N D
SPOOLS	S P UW L Z
GOODWIFE	G UH D W AY F
LANZMANN	L AE N Z M AH N
TUAM	T Y UW AH M
SORROW'S	S AA R OW Z
FRESHETS	F R EH SH AH T S
GATEPOST	G EY T P OW S T
WATTER	W AA T ER
WAITETH	W EY T IH TH
MALOCCLUSIONS	M AE L AH K L UW ZH AH N Z
KENOZHA	K AH N AA Z HH AH
HITOTSU	HH AH T AA T S UW
REARWARD	R IH ER W ER D
PULSATION	P AH L S EY SH AH N
BUS'S	B AH S IX Z
PANTOMIMES	P AE N T AH M AY M Z
WICKERWORK	W IH K ER W ER K
FLOUNCED	F L AW N S T
VJ	V IY JH
GAINST	G EY N S T
ABSENTLY	AE B S AH N T L IY
IKEBANA	AH K EH B AH N AH
INDRYING	IH N D R AY IH NG
MAYA'S	M AY AH Z
BLACKHEAD	B L AE K HH EH D
GARTERSNAKE	G AA R T ER S N EY K
DOORSIDE	D OW R S AY D
WIINGASHK	W IY N G AH SH
ANTIPHONALLY	AE N T IH F AH N AH L IY
BERGERAC	B IH R JH EH R AH K
UNKNOTTING	AH N AA T IH NG
MIDCHEST	M IH D CH EH S T
PICOTÉE	P AH K OW T EY
VIEILLES	V IY AH L Z
ORBS	AO R B Z
UTTERMOST	AH T ER M OW S T
TO'VE	T UW V
FOSCARI	F AA S AH R IY
BARBERSHOPS	B AA R B ER SH AA P S
BARREL'S	B AE R AH L Z
FOOTBRIDGE	F UH T B R IH JH
CLOTHESLINES	K L OW DH Z L AY N Z
WINDLESS	W IH N D L AH S
BADGERLY	B AE JH ER L IY
SPEEKETH	S P IY K AH TH
JACKKNIFE	JH AE K N AY F
POLIAN	P OW L IY AH N
FORBIDDEST	F AO R B IH D AH S T
MURMURINGS	M ER M ER IH NG Z
REFLESH	R IY F L EH SH
GALLEY'S	G AE L IY Z
T'OTHER	T AA DH AH R
COFFEECUP	K AO F IY K AH P
HYPERION'S	HH AY P IH R IY AH N Z
HEATWAVE	HH IY T W EY V
MELODIOUSLY	M AH L OW D IY AH S L IY
HAIGA	HH EY G AH
FORETEETH	F OW R T IY TH
EMOTICONS	IH M OW T IH K AO N Z
SCRATCHER	S K R AE CH ER
CONQUERABLE	K AA NG K ER AH B AH L
JANGLING	JH AE NG G AH L IH NG
SPRINKLER'S	S P R IH NG K L ER Z
EYRY	EY R IY
POUCHED	P AW CH T
SUMMERHOUSE	S AH M ER HH AW S
MALLETS	M AE L EH T S
GUAYMAS	G Y UW EY M AH Z
ROWLEY'S	R OW L IY Z
HUSH'D	HH AH SH D
SHRIVE	SH R AY V
INTERDIT	IH N T AH R D IH T
SAVIOUR'S	S EY V Y ER Z
ANGLER'S	AE NG G L ER Z
GROTT	G R AA T
UNSAYABLE	AH N S EY AH B AH L
GILGAMESH	JH IH L G AH M AH SH
CREATURE'S	K R IY CH ER Z
MORTURE	M AO R CH ER
TAVERNER	T AE V ER N ER
GURGLES	G ER G AH L Z
PACIFICS	P AH S IH F IH K S
MYNAH	M IH N AH
CUMBRANCE	K AH M B R AH N S
EVANGELINE'S	IH V AE N JH IH L AY N Z
GOSLINGS	G OW S L IH NG Z
SHUSHES	SH AH SH AH Z
CHANGEFUL	CH EY N JH F AH L
CLEANER'S	K L IY N ER Z
ARM'D	AA R M D
COMMONPLACES	K AA M AH N P L EY S IH Z
SUNSET'S	S AH N S EH TS
ARMLOAD	AA R M L OW D
PAILFULL	P EY L F UH L
KAISERS	K AY Z ER Z
HOODIES	HH UH D IY Z
VOTARESS	V OW T ER AH S
PINE'S	P AY N Z
GLADNESS	G L AE D N AH S
DAYRAVEN	D EY R EY V AH N
BUMMERS	B AH M ER Z
FABLING	F EY B AH L IH NG
TARRIETH	T AE R IY IH TH
SAILLESS	S EY L AH S
EDEN'S	IY D AH N Z
STILLAMONG	S T IH L AH M AH NG
CHOPIN'S	SH OW P AE N Z
ENJAMBED	EH N JH AE M B EH D
SAMOGITIA	S AE M AH JH IH SH IY AH
BLOWSY	B L OW Z IY
NURSLINGS	N AH R S L AH NG Z
SHEEPFOLDS	SH IY P F OW L D Z
HARP'S	HH AA R P S
ON'T	AA N T
KATYDID'S	K EY T IY D IH D Z
WITTOL	W IH T AH L
BASHO	B AE SH OW
KINE	K AY N
ESTRANGING	IH S T R EY N JH IH NG
FUNNIES	F AH N IY Z
ENCHAINED	EH N CH EY N D
CLOVEN	K L OW V AH N
RAVISH	R EY V IH SH
GRAVID	G R AE V AH D
SLIMED	S L AY M D
BESOUGHT	B IH S AO T
HOD	HH AA D
OSPREYS	AA S P R EY Z
PERCHING	P ER CH IH NG
SOURWOOD	S AW ER W UH D
TWENTYFOURSEVEN	T W EH N T IY F OW R S EH V AH N
RELIT	R IY L IH T
MASSON'S	M AE S AH N Z
KITE'S	K AY TS
SHELTER'D	SH EH L T ER D
SKILFUL	S K IH L F AH L
PERIGEE	P AH R AH JH IY IY
MUDHENS	M AH D HH EH N Z
CHARIOTEER	CH AE R IY AH T IH R
E'E	EH
UNWARE	AH N W EH R
UNTANGLES	AH N T AE NG G AH L Z
ENSHIELD	EH N SH IY L D
SEERSUCKER	S IH ER S AH K ER
FENCEPOSTS	F EH N S P OW S T S
ABODES	AH B OW D Z
UNKOWN	AH N K OW N
KNARLS	N AA R L Z
DISQUIETUDE	D IH S K W AY AH T UW D
KANGAROO'S	K AE NG G ER UW Z
SIDNEIAN	S IH D N IY IY AH N
BULLFROG'S	B UH L F R AO G Z
MORU	M AO R UW
NOELS	N OW EH L Z
DRUDGING	D R AH JH IH NG
XII	Z IY
MINUTEST	M IH N AH T AH S T
DEFLATES	D IH F L EY T S
SAYST	S EY S T
BADAJOS'S	B AH D AE JH AH Z AH Z
BETHOUGHT	B IH TH AO T
BARECHESTED	B EH R CH EH S T IH D
THRONES	TH R OW N Z
TUMID	T UW M AH D
URGIN'S	AH R JH AH N Z
ARMOURY	AA R M ER IY
O'ERWHELMED	AH AH R W HH AH L M D
SEARCHER'S	S ER CH ER Z
PARASANGS	P AA R AH S AE NG Z
PARCHING	P AA R CH IH NG
SLIDESHOW	S L AY D SH OW
FRECKLING	F R EH K AH L IH NG
ALEPPO	AH L EH P OW
CHRYSOSTOM	K R AH S AA S T AH M
GIGGS	JH IH G Z
IV	IH V
FRITILLARIES	F R AH T IH L AH R AY Z
HACERTE	HH AE S AH R T
BRING'ST	B R IH N G S T
BEQUEATHS	B IH K W IY TH S
TRISTESSE	T R IH S T AH S
URNS	ER N Z
BUFFALOES	B AH F AH L OW Z
PENSCRATCH	P EH N S K R AE CH
NIGHTLIGHT	N AY T L AY T
CEREMENTS	S EH R AH M AH N T S
UT	AH T
CHIPMUNK'S	CH IH P M AH NG K S
CORSELET	K AA R S L EH T
IXION'S	IH K S AY AH N Z
CYPRESSES	S AY P R AH S IH Z
YRIAR	Y R AY AH R
NOVOCAIN	N AA V AH K EY N
TISSUELIKE	T IH SH UW L AY K
OBJECTIONABLES	AA B JH IH K SH AH N AH B AH L Z
SALVATORY	S AA V AH T OW R IY
SNOWDONIA	S N OW D OW N Y AH
EARWIG	IH ER W IH G
WINTERY	W IH N T ER IY
STEPPINGSTONES	S T EH P IH NG S T OW N Z
ENTERD	IH N T AH R D
WALLEWAY	W AA L UW EY IY
THERES	DH EH R Z
WRETCHEDNESS	R EH CH AH D N AH S
RAGMAN'S	R AE G M AE N Z
SNOWMEN	S N OW M EH N
NUTRIMENT	N AH T R IY M AH N T
RINGMAIL	R IH NG M EY L
PHRENOLOGIST	F R AH N AA L AH JH AH S T
EFTSOONS	EH F T S UW N Z
BROGUE	B R AA G
MEDUSAE	M EH D Y AH S IY
UNPINNED	AH N P IH N D
QUATRAINS	K W AA T R EY N Z
CANAP'S	K AE N AH P S
CATTAILS	K AE T EY L Z
PORTRAITURE	P OW R T R AH CH ER
MITRAILLEUSE	M IH T R EY L UW Z
HLEONIAN	HH L IY OW N IY AH N
REJOICES	R IH JH OY S IH Z
THYRZA	TH AH R Z AH
DEWDROPS	D UW D R AA P S
CUPPED	K AH P T
HAPHAZARDS	HH AE P HH AE Z ER D Z
SOOTH	S UW TH
UNDERSIDES	AH N D ER S AY D Z
SCREENSAVER	S K R IY N S EY V ER
AETHER	AH IY TH ER
TYBURN	T IH B AH R N
FEATHERD	F IY T HH ER D
CHOCOS	CH AA K AH Z
PETRYSHYN	P EH T R AH SH AH N
DERRICKS	D EH R IH K S
UNTASTED	AH N T EY S T IH D
BUDDHAS	B AH D HH AH Z
NOWAY	N OW EY IY
WAKEFUL	W EY K F AH L
WALLAH	W AA L AH
LISPING	L IH S P IH NG
OVENBIRD	AH V AH N B ER D
FOSTRESS	F AA S T R AH S
TAMARACK	T AE M AH R AH K
BULLRUSHES	B UH L R AH SH IH Z
FEARLESSLY	F IH ER L AH S L IY
WITCHDOCTOR'S	W IH CH D AA K T ER Z
MIGHTEST	M AY T AH S T
ILLUMES	IH L UW M Z
WORCUM	W AH R K AH M
VIREO'S	V IH R IY AH Z
SMILIES	S M AY L IY Z
STILLTHERE	S T IH L TH AH R
RUSHINGS	R AH SH IH NG Z
UNLIT	AH N L IH T
FOLIA	F OW L Y AH
TARN	T AA R N
MOUTH'S	M AW TH S
HIPPODROMES	HH IH P AH D R OW M Z
SPRITZES	S P R IH T S AH Z
LAMPSHADE	L AE M P SH EY D
JELLIBOLEE	JH EH L AH B AH L IY IY
HAMBONE	HH AE M B OW N
TERRACING	T EH R AH S IH NG
HEAVENLIER	HH EH V AH N L IY ER
SLOSHES	S L AA SH IH Z
BUFFETINGS	B AH F AH T IH NG Z
AUSTERLITZ	AO S T AH R L AH T S
CHIMPUNK	CH IH M P AH NG K
POPPER'S	P AA P ER Z
MEM	M EH M
SEDGY	S EH JH IY
WATERLINES	W AO T ER L AY N Z
CAERPHILLY	K IY R F AY L IY
INEXTINGUISHABLE	IH N IH K S T IH NG G W IH SH AH B AH L
MASSIC	M AE S IH K
CLACKETY	K L AE K AH T IY
NAZ	N AE Z
ALOTTED	AH L AA T IH D
SHAMBALA	SH AE M B AH L AH
GODWITS	G AA D W IH T S
TWIX	T W IH K S
SIDEBOARD	S AY D B OW R D
VOMITED	V AA M AH T IH D
FAUN	F AO N
NIGHTWARD	N AY T W ER D
WEATHERVANE	W IY TH AH R V EY N
WRENSONG	R EH N S AH NG
SPHERED	S F IH ER D
GAWD	G AO D
MAYHAP	M EY HH AE P
SUBJUGATION	S AH B JH IH G EY SH AH N
KOOKABURRA	K UH K AH B AH R AH
BOBWHITES	B AA B W AY T S
OROMO	AO R AH M OW
MIROR	M AY R AH R
PILAW	P IH L AH
ADONAI	AE D AH N EY
WISH'D	W IH SH D
HUDIBRAS	HH Y UW D IH B R AH Z
SAIDGOOD	S EH D G UH D
EASEFULLY	IY Z F AH L IY
MASQUE	M AE S K
ORDAINS	AO R D EY N Z
BLINKERS	B L IH NG K ER Z
KINDLES	K IH N D AH L Z
CALLETH	K AO L IH TH
LOTUSES	L OW T AH S IH Z
MOPES	M OW P S
SWATHS	S W AA TH S
CHIGGER	CH IH G ER
PAULINUS	P AO L AH N AH S
TOCSIN'S	T AA K S AH N Z
CLEAROUT	K L IH ER AW T
CARAVELS	K AE R AH V AH L Z
WIFEI	W IH F IY
CLOCKLESS	K L AA K L AH S
PAUPER'S	P AO P ER Z
BODING	B OW D IH NG
ASTAROTH	AE S T AH R AH TH
PILGRIMING	P IH L G R AH M IH NG
BENEDICTIONS	B EH N AH D IH K SH AH N Z
GRAINLESS	G R EY N L AH S
O'ERCOMETH	AH AH R K AH M AH TH
ORTHOPEDIST'S	AO R TH AH P IY D AH S TS
CLOD	K L AA D
SNOWLIT	S N OW L IH T
KOLLWITZ	K AA L W AH T S
MAIDENHOOD	M EY D AH N HH UH D
MIDIANITES	M IH D IY AH N AY T S
FIZZGIGGIOUS	F IH Z IH G IY AH S
SCUDDING	S K AH D IH NG
KAZIM	K AE Z AH M
CURTSEYING	K ER T S IY IH NG
CREEKBED	K R IY K B EH D
DRIV'N	D R IH V N
WOBBLES	W AA B AH L Z
PARNEE'S	P AA R N IY Z
HORBERG	HH AO R B AH R G
WORKHOUSE	W ER K HH AW S
FOXGRAPE	F AA K S G R EY P
HEADLAND	HH EH D L AE N D
SPLENDOUR	S P L EH N D AH R
M'EDGE	M EH JH
PITER	P IH T ER
WORKETH	W ER K IH TH
BUCKET'S	B AH K IH TS
LOVEST	L AH V AH S T
UNKILLABLE	AH N K IH L AH B AH L
ORISONS	OW R IY Z AO N Z
WAYYY	W EY IY
GINS	JH IH N Z
DISCOMFITING	D IH S K AH M F IH T IH NG
PEELINGS	P IY L IH NG Z
GROSBEAK'S	G R OW S B IY K S
LARYNGITIC	L AH R IH N JH AH T AH K
DEVILRY	D IY V IH L R IY
OUTCROP	AW T K R AA P
TRIFLER	T R AY F AH L ER
CRIETH	K R AY IH TH
SHOAL	SH OW L
BACKROAD	B AE K R OW D
TUSTLE	T AH S AH L
THREESCORE	TH R IY S K OW R
SYCAMORES	S IH K AH M AH R Z
THUNDERCLAP	TH AH N D ER K L AE P
TOILETTE	T OY L EH T
NANA'S	N AE N AH Z
RETINAS	R EH T AH N AH Z
SUNLESS	S AH N L AH S
WISHBONES	W IH SH B OW N Z
SCOURGER	S K ER JH ER
DISTEMPERATURE	D IH S T EH M P ER AH CH ER
LIGGIN	L IH JH AH N
COUNTERLIKE	K AW N T ER L AY K
OWRE	OW R
KESTREL	K EH S T R AH L
PARURE	P EH R Y ER
IRIDISCENT	AY ER AH D IY Z S EH N T
IMPOSTS	IH M P OW S T S
SUBJ	S AH B
HAIRGRASS	HH EH R G R AE S
DRINKETH	D R IH NG K IH TH
DOTARD	D AA T AH R D
SIROC	S IH R AH K
DAMSELFLY'S	D AE M Z AH L F L AY Z
STRIDULATES	S T R IH D Y AH L EY T S
NIGHTINGALES	N AY T AH N G EY L Z
VEDIC	V IY D AH K
BUBBLEGUM	B AH B AH L G AH M
PREACHETH	P R IY CH IH TH
STEADIESAND	S T EH D IY S AE N D
FURBELOWED	F ER B IH L OW D
WOODCUT	W UH D K AH T
MERGANSER	M AH R G AE N Z AH R
CLACKED	K L AE K T
PISTOLES	P AY Z T OW L Z
CONNATURAL	K AH N AE CH AH R AH L
GOOSEFLESH	G UW S F L EH SH
GONGULA	G AA N G Y UW L AH
SLEETING	S L IY T IH NG
ARMENIATOWN	AA R M IY N IY AH T OW N
SORROWFULLY	S AA R OW F AH L IY
FRUITBOWL	F R UW T B OW L
SILKWORM'S	S IH L K W ER M Z
WEEPILY	W IY P IY L IY
WETS	W EH T S
JOCKEY'S	JH AA K IY Z
CATASROPHES	K AH T AE Z R AH F S
SCATTERS	S K AE T ER Z
SURREALITY	S ER R IY AE L AH T IY
PARAKEET'S	P EH R AH K IY TS
REFRACTED	R IH F R AE K T IH D
PEREGRINE'S	P EH R AH G R IY N Z
PLOWBOY	P L AW B OY
SIDEWALL	S AY D W AO L
BUTTONING	B AH T AH N IH NG
FILIGREED	F AH L IH G R IY D
AKUTAGAWA'S	AE K Y AH T AE G AH AH Z
METEORITES	M IY T IY AH R AY T S
SAWEST	S AO AH S T
AIK	EY K
WAYWASSIMO	W EY W AA S AH M OW
DREAM'S	D R IY M Z
GORGEOUSLY	G AO R JH AH S L IY
THARE'S	TH AE R AH Z
SHRIKE	SH R AY K
GREATNESSES	G R EY T N AH S IH Z
COCKCROW	K AA K R OW
SAVOURING	S AH V OW Y AH R AH NG
M'AMOUR	M AE M AH R
PERSEVER	P ER S EH V ER
CLYDESDALES	K L IH D AH Z D EY L Z
FORBORE	F AO R B AO R
FRAZER'S	F R EY Z ER Z
SNOWDRIFT	S N OW D R IH F T
HARLEYS	HH AA R L EY Z
STORYTELLER'S	S T AO R IY T EH L ER Z
FA	F AA
REDWING	R EH D W IH NG
TASSETS	T AE S AH T S
ONCOLOGIST'S	AA NG K AA L AH JH IH S TS
HOVELL'D	HH AA V AH L D
INQUIRIN	IH N K W IH R AH N
SMITES	S M AY T S
CROESUS	K R OW Z AH S
FALSER	F AO L S ER
TILL'S	T IH L Z
CLOUD'S	K L AW D Z
UNSEALS	AH N S IY L Z
PRAJNAPARAMITA	P R AE JH N AH P AH R AE M AH T AH
GAYETIES	G EY AH T IY Z
BRIARS	B R AY ER Z
CLIME	K L AY M
UNCANVASSED	AH N K AE N V AH S T
TONIGHTS	T AH N AY T S
GORSE	G AO R S
STREWS	S T R UW Z
SINKERS	S IH NG K ER Z
GOLGOTHA	G OW L G AH TH AH
EFFECTUAL	IH F EH K CH AH W AH L
RETCHES	R EH CH IH Z
DEAL'ST	D IY AE L S T
PLAIN'S	P L EY N Z
MORNNG	M AO R N NG
AFFRIGHT	AE F R AY T
DOLOUR	D AA L AH R
HUMMERS	HH AH M ER Z
INKSTAND	IH NG K S T AE N D
BLUET	B L UW AH T
UNWEANED	AH N W IY N D
TUFFET	T AH F AH T
HIBISCUS	HH AH B IH S AH S
BETRAYETH	B IH T R EY IH TH
FRISB	F R IH Z
MEAGRE	M IY G AH R
GRAMOPHONE	G R AE M AH F OW N
HELLAS	HH EH L AH Z
GORGING	G AO R JH IH NG
EWA	Y UW AH
PERSEID	P AH R S AY D
OSSEO	AA S IY OW
DISCONSOLATE	D IH S K AH N S OW L AH T
STACK'D	S T AE K D
NERVING	N ER V IH NG
CHIRRUP	CH AH R AH P
WOODLICE	W UH D L AY S
TOPMOST	T AA P M OW S T
IVIED	AY V IY D
HEAVENWARD	HH EH V AH N W ER D
RELUCTANCY	R IH L AH K T AH N S IY
WOOER'S	W UW ER Z
DUNYA	D Y UW N AY AH
LIMPET	L IH M P AH T
WATERHOLE	W AO T ER HH OW L
OCOTILLO'S	AA K AH T IH L AH Z
SINEW	S IH N Y UW
SUNRAY	S AH N R EY
FIDDLEHEAD	F IH D AH L HH EH D
FLAGRANCE	F L EY G R AH N S
GONENESS	G AO N AH S
DEPARTETH	D IY P AA R T IH TH
BEFOUL	B IH F AW L
RIVULET'S	R IH V Y AH L AH T S
REZ	R EH Z
VICT	V IH K T
OAKEN	OW K AH N
FRIESLAND	F R AY Z L AE N D
NQONG	N K AO NG
BUTTERBUR	B AH T AH R B AH R
HUNGER'S	HH AH NG G ER Z
SHEETED	SH IY T IH D
MOULDERS	M OW L D ER Z
GYPSY'S	JH IH P S IY Z
CEMETARY	S EH M AH T EH R IY
CANTATAS	K AE N T AH T AH Z
JOURNEY'S	JH ER N IY Z
BOATSIDE	B OW T S AY D
INTOXICANTS	IH N T AA K S IH K AH N T S
FRESHET	F R EH SH AH T
SUMMERING	S AH M ER IH NG
SKATEBOARDS	S K EY T B OW R D Z
ARIGHT	AH R AY T
UNSTRUNG	AH N S T R AH NG
BELDAME	B EH L D EY M
DEMOGORGON	D AH M AH G AO R G AH N
LETTRES	L EH T AH R Z
GENTLEMENS	JH EH N T AH L M EH N Z
FUNNELLED	F AH N AH L D
HIGGINSON'S	HH IH G IH N S AH N Z
MOONFLOWERS	M UW N F L AW ER Z
SEMMLYKEENE	S EH M L AH K IY N
CADENCING	K EY D AH N S IH NG
BAILANDO	B EY L AE N D OW
SUPERFLUITY	S UW P ER F L UW AH T IY
DAYMOON	D EY M UW N
BONDSMEN	B AA N D Z M EH N
O'ER	OW ER
MENSES	M EH N Z IH Z
WORTHILY	W ER DH IY L IY
SUNSHADES	S AH N SH EY D Z
NIGHTBIRD	N AY T B ER D
MEOWING	M IY OW AH NG
MOONBEAM'S	M UW N B IY M Z
BUSKINED	B AH S K IH N D
MOONGLOW	M UW N G L OW
WHENS	W EH N Z
TABACCO	T AH B AE K OW
MARTYR'S	M AA R T ER Z
WIREY	W AY ER IY
JOGUEUSE	JH AA G W UW Z
PLENTITUDE	P L EH N T AH T Y UW D
IMPIOUSLY	IH M P AY AH S L IY
AGAVE	AH G EY V
CORNED	K AO R N D
SWA	S W AA
FUTZ	F AH T S
TAMARIND	T AE M AH R AY N D
CURUNG	K Y UH R AH NG
UNFLEEING	AH N F L IY IH NG
RAININ	R EY N IH N
WWW	D AH B AH L Y UW D AH B AH L Y UW W
EXULTATION	EH K S AH L T EY SH AH N
SONGNET	S AO NG N EH T
ERRATA	EH R AH T AH
LEAF'S	L IY F S
GIRDED	G ER D IH D
SERRIED	S EH R AY D
SUPPERLESS	S AH P ER L AH S
ANTISLAVERY	AE N T AY S L EY V AH R IY
GLEEDS	G L IY D Z
GLISTENS	G L IH S AH N Z
INMOST	IH N M OW S T
UNPEELED	AH N P IY L D
ERASBLE	EH R AH Z AH L
LADDIE	L AE D IY
XVI	Z V IY
MIDRIFFS	M IH D R IH F S
EMU'S	IY M Y UW Z
ROADKILL	R OW D K IH L
GLATSTEIN	G L AE T S T IY N
TEARDROPS	T IH ER D R AA P S
LATMOS	L AE T M AH Z
MEADOWLARK'S	M EH D OW L AA R K S
KIGO	K IH G OW
CRICKETERS	K R IH K AH T ER Z
HEPATICA	HH AH P AE T AH K AH
MERINGUE	M EH R AH NG
CURVACEOUS	K ER V EY SH AH S
NECK'S	N EH K S
STYRIA	S T IH R IY AH
BENUMBED	B IH N AH M D
STREETLAMPS	S T R IY T L AE M P S
SKIFF'S	S K IH F S
AFF	AE F
VELDT	V EH L T
JOHNIE'S	JH AA N IY Z
UNSLEPT	AH N S L EH P T
QUINCTIUS	K W IH NG K T AY AH S
TANAGERS	T AE N IH JH ER Z
FLYCATCHER'S	F L AY K AE CH ER Z
RABBIT'S	R AE B AH TS
SHIMMIED	SH IH M IY D
POLISHES	P AA L IH SH IH Z
ENQUIRES	IH N K W AY ER Z
OER	OW AH R
WALU	W AA L UW
IDYLLS	AY D AH L Z
REMEMBER'D	R IH M EH M B ER D
DISHEVELLED	D IH SH EH V AH L D
EDMOND'S	EH D M AH N D Z
TEDDIES	T EH D IY Z
CRADLED	K R EY D AH L D
BENCHED	B EH N CH T
AMPLER	AE M P AH L ER
UNCONQUERABLE	AH N K AA NG K ER AH B AH L
COGITATING	K OW JH AH T EY T AH NG
UNCARVED	AH N K AA R V D
WARRIOR'S	W AO R IY ER Z
IMPREST	IH M P R AH S T
WHISPY	W IH S IY
WER	W EH R
KORE	K AO R
WRENS	R EH N Z
RUIN'S	R UW AH N Z
HOOTING	HH UW T IH NG
COCKLEBURS	K AA K L EH B Y AH R Z
HORSEMAN'S	HH AO R S M AH N Z
ARBITREMENT	AA R B IH T R M AH N T
FATE'S	F EY TS
TRAVELLER'S	T R AE V AH L ER Z
MUSHROOM'S	M AH SH R UW M Z
ICEBLEAK	AY S B L IY K
MALIGNITY	M AH L AY N AH T IY
ANARCHS	AE N AA R K S
DEATHLESS	D EH TH L AH S
NIGHEST	N AY AH S T
LILLIES	L IH L AY Z
HEDGEROW	HH EH JH R OW
CONTENTEDNESS	K AH N T EH N T AH D N AH S
WELCOMER	W EH L K AH M ER
PATROCLUS	P AE T R AA K L AH S
SUNBRIGHT	S AH N B R AY T
SNAKESKIN	S N EY K S K IH N
PIER'S	P IH R Z
MULOCK	M Y UW L AH K
WAISTCLOTH	W EY S T K L AO TH
BASTIANO	B AE S T IY AH N OW
SOE	S OW
FEJEE	F IY JH IY IY
SATRAPIES	S AE T R EY P IY Z
MOHAMMED'S	M OW HH AE M IH D Z
UNCURLED	AH N K ER L D
PENTAMETERS	P EH N T AE M AH T AH R Z
SAREE	S AH R IY IY
SEASONABLY	S IY Z AH N AH B L IY
RECOMMENCE	R IY K AH M EH N S
KOAN	K OW AH N
NBSP	EH N B IY EH S P
GUNGA	G AH N G AH
HEROINS	HH EH R AH W AH N Z
PARRICIDE	P AE R AH S AY D
WORDLESSLY	W ER D L AH S L IY
WOODSWORTH	W UH D Z W ER TH
FURL	F ER L
PULSATE	P AH L S AH T
DONT	D AA N T
FLORIST'S	F L AA R IH S TS
GEORNE	JH IY AH R N
VEDAS	V EH D AH Z
ARRAIGNING	AH R EY N IH NG
WURZBURG	W AH R Z AH R G
REBLOOMING	R IY B L UW M IH NG
UNCOMPLAINING	AH N K AH M P L EY N IH NG
ASSAYD	AE S EY D
LANIERS	L EY N IY ER Z
DACOTAHS	D AE K AH T AH Z
SNOWBANK'S	S N OW B AE NG K S
BEAUTEOUS	B Y UW T IY AH S
ALLEGRETTO	AE L AH G R EH T OW
PRATE	P R EY T
BLACKSMITH'S	B L AE K S M IH TH S
THESSALONIKI	TH EH S AH L AA N AH K IY
GROWIN	G R OW IH N
SHARPENER	SH AA R P AH N ER
INTERLUNAR	IH N T ER L UW N ER
LIBITUM	L IH B AH T AH M
GAULONITE	G AO L AH N AY T
TRINITARIAN	T R IH N AH T EH R IY AH N
UNBIDDEN	AH N B IH D AH N
VERDURE	V ER JH ER
INFANTINE	IH N F AE N T AY N
HAIRLINES	HH EH R L AY N Z
ROOFLESS	R UW F L AH S
BREERS	B R IH R Z
CAPTIOUS	K AE P SH AH S
BALED	B EY L D
WHITEOUT	W AY T AW T
ENCIRCLES	EH N S ER K AH L Z
DERVISHES	D ER V IH SH IH Z
PETRARCH'S	P EH T R AH R K S
WONDEROUS	W AH N D ER AH S
TANGY	T AE NG IY
SCOFFING	S K AA F IH NG
EASTERTIDE	IY S T ER T AY D
LIVORNESE	L IH V AH R N IY Z
FATEFULLY	F EY T F AH L IY
SLENDERER	S L EH N D ER ER
WATCH'D	W AA CH D
ARRAS	AE R AH Z
RIMOL	R IH M AH L
FARENHEIT	F AE R AH N HH IY T
BOWSPRIT	B OW S R AH T
UNTAMED	AH N T EY M D
SKITTERS	S K IH T ER Z
SHOVELLING	SH AH V AH L IH NG
MOULTING	M OW L T AH NG
UNTREMULOUS	AH N T R EH M Y AH L AH S
HABERSHAM	HH AH B AH R SH AH M
GYRING	JH AY R IH NG
INTERCONNECTEDNESS	IH N T ER K AH N EH K T AH D N AH S
IRVYNE'S	AH R V AY N AH Z
YENADIZZE	Y EH N AH D AH Z
INCLOSED	IH N K L OW Z D
DETACHING	D IH T AE CH IH NG
UNDERFEED	AH N D ER F IY D
MILLENIUM	M IH L IY N IY AH M
JACKALS	JH AE K AH L Z
INCANTS	IH N K AE N T S
MURRDER	M AH R D AH R
UNCELEBRATED	AH N S EH L AH B R EY T IH D
VESPER'S	V EH S P ER Z
PFFFT	P IY EH F EH F EH F T
RESUM	R IY S AH M
MSIPPI	M Z IH P IY
BOSCOMBE	B AA S AH M
GUILLEMOTS	G UW L AH M AH T S
CULLOWHEE	K AH L OW IY IY
CHINS	CH IH N Z
CHURL	CH AH R L
HODDEN	HH AA D AH N
SYMPATHY'S	S IH M P AH TH IY Z
LABOURING	L EY B ER IH NG
TSARS	Z AA R Z
KINGLET	K IH NG L AH T
SACR	S AE K R
RAIN'S	R EY N Z
BRINDLED	B R IH N D AH L D
ABYSSES	AH B IH S IH Z
CARP'S	K AA R P S
SPLENDORS	S P L EH N D ER Z
CONCEITS	K AH N S IY T S
SOLENT	S OW L AH N T
CEREUS	S IH R IY AH S
SEMICHORUS	S EH M IY K OW R AH S
ELEGIES	EH L AH JH IY Z
DIVERSELY	D AY V ER S L IY
HALOED	HH EY L OW D
ROOKERY	R AH K EH R IY
SMOULDER	S M OW L D AH R
FATNESS	F AE T N AH S
ARPEGGIOS	AA R P EH JH IY OW Z
AMBUSH'D	AE M B UH SH D
GAMEY	G EY M IY
MZ	EH M Z
TRANSFIGURED	T R AE N S F IH G Y ER D
NORTHAMPTONSHIRE	N AO R TH AE M P T AH N SH AY R
SPEEDWELL'S	S P IY D W EH L Z
CAROLLINGS	K AE R AH L IH NG Z
FAERIE	F IY R AY
MEDS	M IY D Z
LUNCHBOX	L AH N CH B AA K S
MOONRISE	M UW N R AY Z
GITCHE	JH IH CH
FOOTFALLS	F UH T F AO L Z
HAUTBOY	HH AO T B OW IY
AVAUNT	AE V AH N T
IMPOSSIBILE	IH M P AA S AH B AH L
HAUNCHES	HH AO N CH IH Z
CASHPOINT	K AE SH P OY N T
JAALAM	JH AA L AH M
WEAL	W IY L
UMP	AH M P
MELIBOEUS	M EH L AH B OW AH AH S
SPANIARD'S	S P AE N Y ER D Z
UNFURLS	AH N F ER L Z
HANDBLOWN	HH AE N D B L OW N
RECKS	R EH K S
SLEEP'S	S L IY P S
NAWADAHA	N AO AE D AH HH AH
MEMORIAM	M AH M AO R IY AH M
COL	K AA L
VAIR	V AE AH R
LINGE	L IH N JH
TYRIAN	T AY R IY AH N
COCKSCOMB	K AA K S K OW M
MIZPEH'S	M IH Z P AH Z
PARROTGREEN	P AE R AH T G R IY N
DISUSED	D IH S Y UW S T
PADDOCKY	P AE D AH K IY
MONITORY	M AA N AH T ER IY
FRANGIPANI	F R AE N JH AH P AE N IY
CRAWS	K R AO Z
POCKETKNIFE	P AA K AH T N AY F
WAYFARERS	W EY F EH R ER Z
PERDITION	P ER D AY SH AH N
WHEELCHAIR'S	W IY L CH EH R Z
BROOMSAGE	B R UW M S EY JH
TOYSHOP	T OY SH AA P
IMPUDENT	IH M P Y AH D AH N T
HORSEAPPLES	HH AO R S AE P AH L Z
SANDCASTLE	S AE N D K AE S AH L
EARTHWORKS	ER TH W ER K S
FRANCIS'S	F R AE N S AH S IX Z
STARLING'S	S T AA R L IH NG Z
GENUMEN	JH EH N Y UW M AH N
HOUSEFLIES	HH AW S F L AY Z
LOQUENS	L AA K W AH N Z
LAMENTATION	L AE M AH N T EY SH AH N
PENKNIFE	P EH N AY F
SARABAND	S AE R AH B AH N D
RIFFLING	R IH F L IH NG
STAMMERING	S T AE M ER IH NG
FISTFULS	F IH S T F AH L Z
AFFRAY	AE F R EY IY
REHANDLED	R IY HH AE N D AH L D
LOV'ST	L AA V S T
JEALOUSY'S	JH EH L AH S IY Z
AMAIN	AH M EY N
HOUSHOLD	HH AW SH OW L D
GOTHS	G OW TH S
RECURVE	R IY K ER V
SHOPAHOLICS	SH AA P AH HH OW L IH K S
LL	EH L
CROAKS	K R OW K S
MACNEILE	M AE K N IY AH L
WHINNY	W IH N IY
SQUAR	S K W AE R
TREEFROGS	T R IY F R AA G Z
BEDEW	B IH D UW
SOOKIE	S UH K AY
HEIMAT	HH IY M AH T
COFFINING	K AO F AH N IH NG
PEACH'S	P IY CH IX Z
CABALA	K AE B AH L AH
POMEGRANATES	P AH M EH G R AH N EY T S
SNEYD	S N EY D
FEASTFUL	F IY S T F AH L
MINTY	M IH N T IY
REAPERS	R IY P ER Z
BIN'S	B IH N Z
XXXIV	Z K S K S IH V
VACANTLY	V EY K AH N T L IY
WOODCHUCK'S	W UH D CH AH K S
BRINGER	B R IH NG ER
MAPLE'S	M EY P AH L Z
ANTENATAL	AE N T AH N AH T AH L
UNREVEALED	AH N R IH V IY L D
XIMENES	Z AH M IY N Z
UNLEARNED	AH N L ER N D
HUNTSMAN'S	HH AH N T S M AH N Z
KINGLET'S	K IH NG L AH T S
LIGHTSOMENESS	L AY T S AH M N AH S
MOTUARA	M AA T Y UW AH R AH
NAVELS	N EY V AH L Z
PERIL'S	P EH R AH L Z
FLASHMOB	F L AE SH M AA B
AZRAEL	AE Z R IY L
ATWEEN	AE T W IY AH N
UNFELT	AH N F EH L T
IMPETUOUSLY	IH M P EH CH AH W AH S L IY
FF	EH F
HARPIST'S	HH AA R P IH S TS
UNDEBASED	AH N D IY B EY S T
WRITHES	R AY DH Z
RECIEVE	R AH S IY V
FLIETH	F L AY IH TH
SALUTATION	S AE L Y AH T EY SH AH N
RAPTURES	R AE P CH ER Z
BRAWLERS	B R AO L ER Z
BARMAID	B AA R M EY D
SCINTILLATING	S IH N T AH L EY T IH NG
ITHAKA	IH TH AH K AH
AWAKING	AH W EY K IH NG
BLAM	B L AE M
SOLILOQUIZING	S OW L IH L AH K W AY Z AH NG
TUBER'S	T UW B ER Z
UNMEANING	AH N M IY N IH NG
GLADIOLA	G L EY D IY AH L AH
BARBWIRE	B AA R B W AY ER
RINGER'S	R IH NG ER Z
PIANOBLACK	P IY AE N OW B L AE K
UNHOOKING	AH N HH UH K IH NG
CJ	S IY JH
DIMINUENDO	D AH M IH N Y UW EH N D OW
CURRANT	K ER AH N T
VERANDAH	V AH R AE N D AH
UNLOVELY	AH N L AH V L IY
TITUBA	T IH T Y UW B AH
DOLEFULLY	D OW L F AH L IY
DEFENESTRATE	D IY F EH N AH S T R EY T
SUBPRIME	S AH B P R AY M
WIMPLE	W IH M P AH L
CANDESCENT	K AE N D IH S EH N T
GLOWY	G L OW IY
UNHARNESSED	AH N HH AA R N AH S T
UPBRAIDING	AH P B R EY D IH NG
ROWERS	R OW ER Z
FRILLED	F R IH L D
WORDLESSNESS	W ER D L AH S N AH S
TREMBLES	T R EH M B AH L Z
PIGTAIL	P IH G T EY L
HYGELAC	HH IH JH AH L AH K
PALOVERDE	P AE L AH V AH R D
SNATCH'D	S N AE CH D
OUTSPEEDED	AW T S P IY D IH D
OLGER	OW L JH AH R
BEPPO	B AH P OW
CREAKS	K R IY K S
SQUALLED	S K W AO L D
CARBUNCLES	K AA R B AH NG K AH L Z
PLASHY	P L AE SH IY
QUICKEANDS	K W IH K IY N D Z
SCAREDOF	S K AE R AH D AH F
FALCON'S	F AE L K AH N Z
RIBBONING	R IH B AH N IH NG
SACSANAGH	S AE K S AH N AH
BK	B IY K
CORKSCREWS	K AO R K S K R UW Z
SIMILE	S IH M AH L IY
DELIGHTSOME	D IH L AY T S AH M
EFFACED	IH F EY S T
MOONSHADOW	M UW N SH AE D OW
EOTENS	IY AH T AH N Z
DUSK'S	D AH S K S
STRINGENCIES	S T R IH NG AH N S IY Z
MARRIAGEABLE	M AE R IH JH AH B AH L
COVERTURE	K AH V ER CH ER
FORT'S	F AO R TS
GHOSTING	G OW S T IH NG
AEOLIAN	EH OW L IY AH N
WALPURGISNACHT	W AA L P AH R JH IH Z N AH CH T
COUNTERPOISE	K AW N T ER P OY Z
WHEREON	W EH ER AO N
CONTRADICTETH	K AA N T R AH D IH K T IH TH
SURFER'S	S ER F ER Z
BLUEGILLS	B L UW G IH L Z
SYDNEIAN	S IH D N IY IY AH N
PREC	P R EH K
SANDPIPER	S AE N D P AY P ER
SCULPTOR'S	S K AH L P T ER Z
WHELKS	W EH K S
CANST	K AE N S T
POETESS	P OW AH T AH S
SKINNIED	S K IH N IY D
SATIATE	S EY SH IY EY T
EMIGRANT'S	EH M AH G R AH N TS
WHO'ER	W AA AH R
LOITERED	L OY T IY R D
PAROS	P AA R AA S
OWAISSA	OW EY S AH
MOUSETRAPS	M AW S T R AE P S
TATTING	T AE T IH NG
UNWONTED	AH N W OW N T IH D
VASARI	V AE S AH R IY
FROWARD	F R OW AH R D
CUCHULAIN	K AH CH AH L EY N
SWABIAN	S W EY B IY AH N
PROPRIETIE	P R AH P R AY AH T IY
SAVOUR	S AE V AH R
SEAL'D	S IY L D
BOOTPRINTS	B UW T P R IH N T S
PALENESS	P EY L N AH S
UNWITHERING	AH N W IH DH ER IH NG
SAVELLA	S AH V EH L AH
SENDAI	S EH N D EY
PLOPS	P L AA P S
THREATENINGS	TH R EH T AH N IH NG Z
DUVET	D Y UW V AH T
FRONTDOOR	F R AH N T D OW R
WAKENING	W EY K AH N IH NG
HUSHES	HH AH SH IH Z
KNEADEN	N IY D AH N
UNDERTAKERS	AH N D ER T EY K ER Z
SCRUBWOODS	S K R AH B W UH D Z
REVISTS	R EH V IH S T S
OPED	OW P T
PEPPERCORN	P EH P ER K AO R N
MUEZZIN'S	M Y UW EH Z AH N Z
JUXON	JH AH K S AH N
WARBLER'S	W AO R B L ER Z
COULDN	K OW AH L D N
LIBERATIONS	L IH B ER EY SH AH N Z
EXTINGUISHES	IH K S T IH NG G W IH SH IH Z
PLAYMATE'S	P L EY M EY TS
GLISSANDO	G L IH S AE N D OW
MEZCAL	M EH Z K AH L
PIERCES	P IH ER S IH Z
SCLIMIN	S K L IH M AH N
UNSOUGHT	AH N S AO T
GALAHS	G AE L AH Z
MANGROVES	M AE N G R OW V Z
VYAZEMSKY	V AY AH Z EH M S IY
TRELAWNY	T R EH L AH N IY
BREATHINGS	B R IY DH IH NG Z
ANEMONIES	AH N EH M AH N AY Z
MOSCON	M AA S AH N
WADDLING	W AA D L AH NG
LUNGFUL	L AH NG F AH L
CALLIGRAPHER'S	K AH L IH G R AH F ER Z
MACCABAEUS	M AE K AE B IY AH S
DEWDROP	D UW D R AA P
SAWHORSE	S AO HH AO R S
EOTENISE	IY AA T AH N AY Z
FUTURITY	F Y UW CH ER AH T IY
XXXV	EH K S EH K S EH K S V
MENFOLK	M EH N F OW K
DÉCAPOTÉES	D EY K AH P OW T EY S
FEORH	F IY AH R
SAMHAIN	S AE M HH EY N
CURLEW	K AH R L UW
BOURB	B OW R B
PRINKED	P R IH NG K T
ILLUMING	IH L UW M AH NG
CHEMIN	K EH M AH N
TANNENBAUMSERIE	T AE N EH N B AH M Z IY R AY
SEUSS'S	S UW S IX Z
TREADETH	T R EH D IH TH
SKUNK'S	S K AH NG K S
UPROSE	AH P R OW Z
CROSSWINDS	K R AO S W IH N D Z
TWIG'S	T W IH G Z
CORVID	K AA R V IH D
SHEW'D	SH UW D
EPHEMERIS	AH F EH M AH R AH S
PROPHET'S	P R AA F AH TS
UNMAKE	AH N M EY K
BEGONE	B IH G AO N
FYTE	F AY T
DAPPLE'S	D AE P AH L Z
EF	EH F
PHANTOMNESS	F AE N T AH M N AH S
STILLING	S T IH L IH NG
FALL'N	F AE L N
FORWARNS	F AO R W AO R N Z
GRAZES	G R EY Z IH Z
AJDABIYA	AE JH D AH B IY AY AH
PHYSIC	F AY Z AH K
CHIBIABOS	CH AH B IY AH B AH Z
FORSYTHIA'S	F AO R S IH TH IY AH Z
UNCLOSE	AH N K L OW Z
SFUMATO	S F Y UW M AH T OW
ADV	AE D
TARWEED	T AA R W IY D
TROLLEYBARN	T R AA L IY B AA R N
BISECTING	B AY S EH K T IH NG
BAT'S	B AE TS
REDWINGS	R EH D W IH NG Z
RECUMBENT	R IH K AH M B AH N T
DEMONIAC	D IH M OW N IY AE K
SLINGSHOTTING	S L IH NG SH AA T IH NG
GRIMED	G R AY M D
SIMONIDES	S IH M AH N AY D Z
CRYPTOMERIAS	K R IH P T AH M IY R IY AH Z
FOSSICKS	F AA S AH K S
ARELAUGHTER	AH R IY L AE F T ER
DIANTHUS	D AY AE N TH AH S
CORN'S	K AO R N Z
MIDSTRIDE	M IH D S T R AY D
MISHE	M IH S IY
HUMANISE	HH AH M AE N AH S
ALEP	AE L AH P
IMPRECATIONS	IH M P R IH K EY SH AH N Z
WINTERLAND	W IH N T ER L AE N D
HIBERNATING	HH AY B ER N EY T IH NG
MOONFLOWER	M UW N F L AW ER
WISDOM'S	W IH Z D AH M Z
III	IY IY
SWISHING	S W IH SH IH NG
RIFFLED	R IH F AH L D
KNELLING	N EH L AH NG
PEASANT'S	P EH Z AH N TS
RECOMMENCED	R IY K AH M EH N S T
SPARROW'S	S P EH R OW Z
AGIB	AE JH AH B
ELK'S	EH L K S
WHICHINFINITY	W AH CH IH N F IH N AH T IY
WALLOPED	W AA L IH P T
SAYETH	S EY IH TH
PIKA	P IH K AH
AMBLONGUSSES	AE M B L AA N G AH S AH Z
FEOR	F IY AH R
INDOLENCE	IH N D AH L AH N S
SHODDEN	SH AA D AH N
VAUNTINGLY	V AO N T IH NG L IY
INHALES	IH N HH EY L Z
EMBRANGLEMENT	IH M B R AE N G L M AH N T
DUSTPAN	D AH S T P AE N
DRAUGHTY	D R AE F T IY
NOONTIDE	N UW N T AY D
WINDOW'S	W IH N D OW Z
UNERRINGLY	AH N EH ER IH NG L IY
BAAING	B AA AH NG
AFORETIME	AH F OW R T AY M
ITRI	IH T R IY
CARNIES	K AA R N IY Z
WYLSUM	W IH L S AH M
MN	EH M N
SAIJIKI	S EY JH AH K IY
LAUD'S	L AO D Z
KOI	K OY
GRANDEE	G R AE N D IY
BONDMAN'S	B AA N D M AE N Z
BAIRNS	B AE AH R N Z
SCABBED	S K AE B D
APPREHENDS	AE P R IH HH EH N D Z
VILLANY	V IH L AH N IY
ATTHIS	AE T TH AH S
COYOTE'S	K AY OW T IY Z
PERFIDIOUS	P ER F IH D IY AH S
UNTIES	AH N T AY Z
STRAN	S T R AE N
PEACOCK'S	P IY K AA K S
RU'TH	R AH TH
PALLOR	P AE L ER
THRUSH'S	TH R AH SH IX Z
PITIES	P IH T IY Z
WC	D AH B AH L Y UW K
HELVELLYN	HH EH L V EH L AH N
ACADIAN	AH K EY D IY AH N
CLAIM'D	K L EY M D
TUBEROSE	T AH B IH R OW S
FERMAT'S	F AH R M EY T S
BOLSENA'S	B OW L S AH N AH Z
BROADNESS	B R AO D N AH S
LOUVER	L UW V ER
SHOULD'ST	SH OW L D S T
PHRYGIA'S	F R IH JH IY AH Z
UNDECEIVED	AH N D IH S IY V D
ZAZEN	Z EY Z AH N
PRESBYOPIC	P R IY S B AY AH P AH K
DURIANS	D Y UH R IY AH N Z
NUTHATCH	N AH T HH AE CH
EALDRE	EH L D AH R
EEVNINGS	IY V N AH NG Z
TOOTHACHE	T UW TH EY K
SLUMBERETH	S L AH M B ER IH TH
ARAK	AE R AH K
RHODODENDRONS	R OW D AH D EH N D R AH N Z
LISANDER	L AH S AE N D AH R
RESOW	R IY S AW
BEARETH	B AE ER IH TH
BEETLE'S	B IY T AH L Z
CARPARK	K AA R P AA R K
TENDERER	T EH N D ER ER
WHATCHAMACALLITS	W AA CH AH M AH K AE L AH T S
VA	V AA
MAYTIME	M EY T AY M
DAZZLES	D AE Z AH L Z
LORDLIER	L AO R D L IY ER
MINGLINGS	M IH NG G AH L IH NG Z
MORONIC	M AO R AH N AH K
UNRISEN	AH N R AY Z AH N
FLITTED	F L IH T IH D
FOEMAN	F OW M AE N
AMPTMAN'S	AE M P T M AH N Z
UNPEEL	AH N P IY L
COMPLAISANCE	K AH M P L EY S AH N S
CHAFFER	CH AE F ER
SAYABLE	S EY AH B AH L
DUMPSTER'S	D AH M P S T ER Z
HEADEND	HH EH D EH N D
EPIDIDYMIS	EH P AH D IH D AH M AH S
WATERSTRIDER	W AO T ER S T R AY D ER
SMOOTHES	S M UW DH Z
RAM'S	R AE M Z
OFFSHORING	AO F SH OW R IH NG
CROONED	K R UW N D
WHEREOF	W EH ER AH V
RESEMBLEST	R IH Z EH M B AH L AH S T
WOULD'ST	W OW L D S T
AMORETTI	AE M AH R EH T IY
GEGYRWED	JH EH JH AH R W D
COFFEEPOT	K AO F IY P AA T
SPRUCES	S P R UW S IH Z
OLAF'S	OW L AA F S
RAYSOUN	R EY S AW N
PARTINGS	P AA R T IH NG Z
UPBUILT	AH P B IH L T
STARGAZING	S T AA R G EY Z IH NG
ALGEBAR	AE L JH AH B AH R
TINKLES	T IH NG K AH L Z
RENENWED	R AH N EH N W D
TRICYCLES	T R IH S AH K AH L Z
WHELK'S	W EH L K S
IAGOO	AY AH G UW
CHILLNESS	CH IH L N AH S
SAUNTERING	S AO N T IY R AH NG
ROUSES	R AW Z IH Z
BARNACLED	B AA R N AH K AH L D
ALMANACK	AE L M AH N AH K
WITFUL	W IH T F AH L
SKIER'S	S K AY R Z
CHIFFONNADE	CH IH F AH N EY D
UNBLEST	AH N B AH L AH S T
CREEPED	K R IY P T
QUENCHED	K W EH N CH T
ASPHODELS	AE S AH D AH L Z
HAMMOCK'S	HH AE M AH K S
GOTTDAM	G AA T D AH M
UNGRACIOUS	AH N G R EY SH AH S
UDDER'D	AH D AH R D
PUDGE	P AH JH
DOORSCRAPER	D OW R S K R EY P ER
CLOVERS	K L OW V ER Z
SUFFUSION	S AH F Y UW ZH AH N
DECRYSTALIZING	D IY K R IH S T AH L AY Z IH NG
LOOKETH	L UH K IH TH
ÉQUILIBRE	EY K W IH L AH B AH R
BOREAL	B AO R AH L
CRICCIETH	K R IH K S IY AH TH
LYDIAN	L AY D IY AH N
MEDAMIN	M EH D AH M AH N
WORDUM	W AH R D AH M
WOODYARDS	W UH D Y AA R D Z
HABERDASHER'S	HH AH B AH R D AH SH AH R Z
WHATE'ER	W AA T AH AH R
WAXEN	W AE K S AH N
CHERRYWOOD	CH EH R IY W UH D
VET'S	V EH TS
DELLS	D EH L Z
HOUND'S	HH AW N D Z
STRAVAG	S T R AE V AH G
SNORTINGS	S N AO R T IH NG Z
WROTH	R AA TH
PERFECTIONS	P ER F AH K SH AH N Z
WHELMED	W EH L M D
HELLESPONT	HH EH L EH S AH N T
TINFUL	T IH N F AH L
NACRE	N EY K AH R
PITCHPOTS	P IH CH P AA T S
UPHEAV'D	AH F IY V D
SMUDGES	S M AH JH IH Z
RELIGHTING	R IY L AY T IH NG
MIDNIGHT'S	M IH D N AY TS
LEADLESS	L IY D L AH S
HAYSHED	HH EY SH EH D
CHIRPED	CH ER P T
SUNCATCHERS	S AH N K AE CH ER Z
UNVOYAGEABLE	AH N V OY IH JH AH B AH L
AWAKES	AH W EY K S
CUTLASSES	K AH T L AH S IH Z
SCYCLE	S IH K AH L
RELIQUES	R AH L IH K S
CAROLERS	K AE R AH L ER Z
THUNDERHEADS	TH AH N D ER HH EH D Z
EUCALYPT	Y UW K AH L AH P T
SINNER'S	S IH N ER Z
MIDNIGHTS	M IH D N AY T S
PARADISES	P AE R AH D AY S IH Z
CAWING	K AO IH NG
GRIEV'D	G R IY V D
KNOCKER	N AA K ER
SANDHILLS	S AE N D HH IH L Z
CURST	K AH R S T
BELTANE	B IH L T EY N
CORNSILK	K AO R N S IH L K
STATURES	S T AE CH ER Z
STRIDERS	S T R AY D ER Z
HISSS	HH IH S
EXCULPATION	IH K S AH L P EY SH AH N
NAPE	N EY P
FOREKNOW	F OW R N OW
CAKING	K EY K IH NG
WHERETO	W EH R AH T OW
PEALS	P IY L Z
FAILD	F EY L D
BENDABLE	B EH N D AH B AH L
GLIST'RING	G L IH S T R AH NG
SILVERED	S IH L V ER D
SMARTIFICIAL	S M AA R T AH F IH S IY AH L
BREADMAKER	B R EH D M EY K ER
SMOKEHOUSE	S M OW K HH AW S
UNTUNED	AH N T UW N D
BYRNIE	B AH R N AY
THINK'ST	TH IH NG K S T
PARAPLEGIC'S	P EH R AH P L EH G IH K S
SEEKETH	S IY K IH TH
SEREING	S IH R IY AH NG
CHAINSAWED	CH EY N S AO D
WHEATFIELDS	W IY T F IY L D Z
UNCOILS	AH N K OY L Z
MINSTRELSIES	M IH N S T R AH L Z IY Z
SURCINGLES	S AH R S AH N G AH L Z
TINSELS	T IH N S AH L Z
JIGGED	JH IH G D
PHARSALIA	F AA R S EY L Y AH
GRASSBLOWN	G R AE S B L OW N
IMPONERE	IH M P OW N AH R
TINSMITH	T IH N S M IH TH
PRODUC'D	P R OW D AH K D
VACUM	V AE K AH M
WAS'T	W AA S T
OVERLIVE	OW V ER L IH V
SOPHIST	S AA F AH S T
ALACK	AH L AE K
HIRELING	HH AY ER L IH NG
WOODPECKER'S	W UH D P EH K ER Z
BILLOW'S	B IH L OW Z
IMBIBING	IH M B AY B IH NG
TURN'ST	T AH R N S T
BEEKEEPER'S	B IY K IY P ER Z
HOUSEFLY'S	HH AW S F L AY Z
LECHER'SLECHER	L EH CH ER Z L EH CH ER
VAUNT	V AO N T
MATCHLESS	M AE CH L AH S
NARRA	N AE R AH
STRIPLIGHTS	S T R IH P L AY T S
ZAM	Z AE M
BIRDOFREDUM	B AY R D AA F R AH D AH M
DUMBWAITER	D AH M W EY T ER
DORES	D AO R Z
FRANSISCO	F R AE N S IH S OW
THEREAT	TH IY R IY T
TRANCES	T R AE N S IH Z
PINAFORES	P IH N AH F OW R Z
TRYSTING	T R AY S T IH NG
FLITS	F L IH T S
FORBEARING	F AO R B AE ER IH NG
CHIEFEST	CH IY F AH S T
RAINFORST	R EY N F AH R S T
TINEY'S	T AY N IY Z
ENTABLATURE	EH N T EY B AH L AH CH ER
PLEASETH	P L IY Z IH TH
E'ER	EH AH R
BARRISTA	B AE R IH S T AH
BLOWFLY'S	B L OW F L AY Z
QUICKLING	K W IH K L IH NG
PAPAM	P AE P AH M
MAYFLOWERS	M EY F L AW ER Z
TRUTH'S	T R UW TH S
FELICIAN	F IY L IH S IY AH N
TREEHOUSE	T R IY HH AW S
CARTOGRAPHER	K AA R T AA G R AH F AH R
JEZEBEL	JH EH Z AH B AH L
BRAVETH	B R EY V IH TH
CHALKBOARD	CH AO K B OW R D
SAIDST	S EY D S T
SLAUGHTERYARD	S L AO T ER Y AA R D
MYRIADS	M IH R IY AH D Z
MILKMOON	M IH L K M UW N
COCOTTE	K OW K AH T IY
WOT	W AA T
STREWED	S T R UW D
SAPIENT	S AE P IY AH N T
ESAU'S	IY S AO Z
RESTOR'D	R EH S T ER D
SCATHED	S K EY DH D
FOEHN	F OW AH N
HURTLES	HH ER T AH L Z
DOORYARD	D OW R Y AA R D
CARAMILLO	K AE R AH M IH L OW
IRAD	IH R AH D
POME	P OW M
CELLAR'S	S EH L ER Z
HEIGH	HH EY
JALOUSIES	JH AE L AW S AY Z
UNLOOSE	AH N L UW S
PRECISEST	P R IH S AY S AH S T
STIPPLED	S T IH P AH L D
GALETTE	G EY L EH T
DESCENDST	D IH S EH N D S T
HESPEREAN	HH EH S IH R IY AH N
TENSES	T EH N S IH Z
OLIMP	AA L AH M P
DIDST	D IH D S T
TOILSOME	T OY L S AH M
QUARRELLING	K W AO R AH L IH NG
MUGO	M Y UW G OW
SLIDINTO	S L AH D IH N T OW
PEEPAL	P IY P AH L
LENGHTENING	L EH N T IY N AH NG
VELLUM	V EH L AH M
HABEMUS	HH AE B AH M AH S
UNERRING	AH N EH ER IH NG
INCHKENNETH	IH N CH K EH N IH TH
GILDAS	JH IH L D AH Z
LUCK'S	L AH K S
AQUAJOGGING	AE K W AH JH AA G IH NG
HOSANNA	HH AH S AE N AH
SCRIBBLINGS	S K R IH B AH L IH NG Z
GAIETY	G EY AH T IY
PLASH	P L AE SH
SHECHEM	SH EH K AH M
ANNOUNCER'S	AH N AW N S ER Z
SHO'NUF	SH AA N AH F
SHIKI	SH IH K IY
FAITHLESS	F EY TH L AH S
BUGLER	B Y UW G AH L ER
FRETWORK	F R EH T W ER K
INTROSPECTION'S	IH N T R AH S P EH K SH AH N Z
EXPECTANTLY	IH K S P EH K T AH N T L IY
BOUGAINVILLEAS	B AW G EY N V IH L IY Z
PLOUGHING	P L AW AH NG
WIPER'S	W AY P ER Z
HASHTAGS	HH AE SH T AE G Z
CLODS	K L AA D Z
DRIZZLES	D R IH Z AH L Z
GNAT'S	N AE TS
SUNBATHES	S AH N B EY DH Z
PILEATED'S	P AY L EY T IH D Z
WASABI	W AA S AH B IY
TRIX	T R IH K S
WOODSHOP	W UH D SH AA P
FISHNET	F IH SH N EH T
RUMPS	R AH M P S
YOURE	Y OW Y AH R
COLLOPS	K AA L AA P S
SEEDTHE	S IY D
SPLUTTERS	S P L AH T AH R Z
BESHREW	B IH SH R UW
SUBLIMATE	S AH B L AH M EY T
SUBSTRATUM	S AH B S T R AE T AH M
NONSENSISTS	N AA N S EH N S IH S T S
ENRINGS	EH N R IH NG Z
SNOWFIELD	S N OW F IY L D
LEVITATES	L EH V AH T AH T S
INCONSTANT	IH N K AA N S T AH N T
AHELION	AH HH IY L IY AH N
MEDEVAC	M EH D AH V AH K
SWALE	S W EY L
HENGESTE	HH EH N JH AH S T
UNLACED	AH N L EY S T
FLATTENS	F L AE T AH N Z
AUTOEROTIC	AO T OW IH R AA T IH K
WINDSCREEN	W IH N D S K R IY N
SCYTHING	S IH DH AH NG
UNDERSINGS	AH N D ER Z IH NG Z
JOCASTA	JH AH K AE S T AH
WITHDRAWNNESS	W IH TH D R AO N AH S
DUMAS'S	D UW M AH Z IX Z
GARNER'D	G AA R N ER D
WENDED	W EH N D AH D
SUDOKU	S UW D AH K UW
IMPEACH'D	IH M P IY CH D
BULBUL'S	B UH L B Y AH L Z
HEALFDENE'S	HH EH L F D IY N AH Z
SOEVER	S OW AH V AH R
SLAYETH	S L EY IH TH
GRAVESEND	G R EY V S EH N D
HELMED	HH EH L M D
CEO'S	S IY IY OW Z
SUNGLARE	S AH N G L EH R
JOYOUSLY	JH OY AH S L IY
MAGICIAN'S	M AH JH IH SH AH N Z
SORCERIES	S AO R S AH R IY Z
YELLOWJACKETS	Y EH L OW JH AE K AH T S
UNFREQUENTED	AH N F R IY K W AH N T IH D
WASN	W AA Z N
WRAPT	R AE P T
SILTED	S IH L T AH D
GALILEANS	G AE L AH L IY N Z
WREATHING	R IY DH IH NG
WERTHER'S	W ER DH ER Z
PINECONES	P AY N K OW N Z
STRANGULATED	S T R AE NG G Y AH L EY T IH D
DROOPS	D R UW P S
HEARTACHING	HH AA R T EY K IH NG
BIRCHBARK	B ER CH B AA R K
BURNETH	B ER N IH TH
ARCHY	AA R CH IY
CHRYSANTHAMUMS	K R AH S AE N TH AH M AH M Z
STALAGMITES	S T AA L AA G M AY T S
BEAT'S	B IY TS
NAKEDNESS	N EY K AH D N AH S
FLAMS	F L AE M Z
ENDOR	EH N D ER
LAMPLIGHT	L AE M P L AY T
GANNETS	G AE N AH T S
NASHI	N AE SH IY
BEKIESZ	B AH K IY Z
GRINNY	G R IH N IY
FANCY'S	F AE N S IY Z
GIOVANNA	JH AY AH V AE N AH
FORSAKEST	F AO R S EY K AH S T
ANKUS	AE NG K AH S
SUNROLLING	S AH N R OW L IH NG
WEFT	W EH F T
KITH	K IH TH
SLUICES	S L UW S IH Z
PS	P IY S
RUFFED	R AH F T
SOMEONES	S AH M W AH N Z
ABRAHAM'S	EY B R AH HH AE M Z
CAMANCHES	K AH M AE N CH AH Z
SHRIMP'S	SH R IH M P S
SPLIFF	S P L IH F
SPEAKETH	S P IY K IH TH
PHILOTADPOLE	F AH L AA T AH D P OW L
PULING	P Y UW L AH NG
SHRIVELLED	SH R IH V AH L D
PLONK	P L AO NG K
OFFENCE	AH F EH N S
ZOR	Z AO R
CIVILISATION	S IH V AH L IY Z EY SH AH N
DRAWEST	D R AO AH S T
SUPREMEST	S UH P R IY M AH S T
HROTHGAR	HH R AA TH G AH R
SLINK	S L IH NG K
BROMELIADS	B R AH M IY L IY AH D Z
FLOATIN	F L OW T IH N
PAINTBOX	P EY N T B AA K S
VAPOUR	V AE P AH R
TUN	T AH N
WHETTING	W EH T IH NG
WHITETHROAT'S	W AY T TH R OW T S
ZUSHIO	Z AH SH IY OW
PLOUGHMEN	P L AW M AH N
CANDLE'S	K AE N D AH L Z
VALOUR	V AE L AH R
PASHTO	P AE SH T OW
KNEADS	N IY D Z
UNUTTERABLE	AH N AH T ER AH B AH L
BUTTEFLY	B Y UW T F L AY
POTTING	P AA T IH NG
BLACKBIRD'S	B L AE K B ER D Z
THUNDERCLOUDS	TH AH N D ER K L AW D Z
MIDRIFF	M IH D R IH F
CHRYSOLITE	K R IH S AH L AY T
MISTED	M IH S T EH D
MATTERHORN	M AE T ER HH AO R N
CRESCENT'S	K R EH S AH N TS
PASSIONFLOWER	P AE SH AH N F L AW ER
GUGOO	G Y UW G UW
BAIRN	B AE AH R N
FRA	F R AA
ALMIGHTIE	AE L M AY T AY
BONDAGES	B AA N D IH JH IH Z
MYRRHA	M AH R AH
PRAYING'S	P R EY IH NG Z
MAUR	M AO R
SW	EH S W
CLIFFPATH	K L IH F P AE TH
HEARSE'S	HH ER S IX Z
COWRIE	K OW R AY
ROUNDELAY	R AW N D EH L EY IY
SCENTING	S EH N T IH NG
SOHRAB'S	S AA R AH B Z
DESIGN'D	D IH Z AY N D
TEASHOP	T IY SH AA P
THIBET	TH IH B AH T
GUTHRUM	G AH TH R AH M
UNTHRIFT	AH N TH R IH F T
IRRETRIEVABLES	IH R IH T R IY V AH B AH L Z
BEASTHOOD	B IY S T HH UH D
VGLN	V IY JH IY EH L N
PRUSSIANS	P R AH S IY AH N Z
MOUTEN	M OW Y UW T AH N
ENTHRALL	IH N TH R AE L
SORROWINGS	S AA R OW IH NG Z
SOUTHEND	S AW TH EH N D
DAEMONIC	D IY M AH N AH K
FLATTERERS	F L AE T ER ER Z
TONKAWA	T AO NG K AH AH
SALVERS	S AA V ER Z
DOTED	D OW T IH D
WAKED	W EY K T
TIMIDER	T IH M AH D ER
THREEWAY	TH R IY W EY
DEFILED	D IY F AY L D
FIREBOX	F AY ER B AA K S
WHOSEHAND	W AA S AH HH AH N D
SIDEREAL	S AY D R IY L
SUBJOINED	S AH B JH OY N D
MAECENAS	M IY S AH N AH Z
WINDFUCKER	W IH N D F AH K ER
ROLL'D	R OW L D
BUCKLERS	B AH K AH L ER Z
PEDANTRIES	P EH D AH N T R IY Z
DOTARD'S	D AA T AH R D Z
REPELLANT	R IH P EH L AH N T
SOFTBOILED	S AO F T B OY L D
VERRAZANO	V EH R AE Z AH N OW
MINDFULNESS	M AY N D F AH L N AH S
KNOWEST	N OW AH S T
THESTYLIS	TH EH S T AH L AH S
HELOISE	HH AH L OY Z
SIGNIFICATION	S IH G N IH F IH K EY SH AH N
WHENAS	W EH N AH Z
LOVEBIRDS	L AH V B ER D Z
JUNCOS	JH AH NG K AH Z
RETOLD	R IY T OW L D
VINEBURG	V IH N AH B AH R G
THORNING	TH AO R N IH NG
JEWELLER	JH UW AH L ER
ALIGHTS	AH L AY T S
NERVED	N ER V D
VAPOROUS	V EY P ER AH S
WOMANLY	W UH M AH N L IY
FOUNTAIN'S	F AW N T AH N Z
DEARNESS	D IH ER N AH S
SPOONING	S P UW N IH NG
ABYSM	AE B AH Z AH M
LANTERN'S	L AE N T ER N Z
SINECURE	S AY N K Y UH R
CHERUBINA'S	CH AH R UW B AH N AH Z
SUCKLES	S AH K AH L Z
UNTAUGHT	AH N T AO T
ROOFTILES	R UW F T AY L Z
FLYIN	F L AY IH N
STRALENHEIM'S	S T R AE L AH N HH IY M Z
HURKLE	HH AH R K AH L
NIGHTCAPS	N AY T K AE P S
TRAJETTO	T R AH JH EH T OW
PAPAI	P AE P EY
AMORPHAS	AH M AO R F AH Z
CRAWLERS	K R AO L ER Z
GINKO	JH IH NG K OW
PATHLESS	P AE TH L AH S
MORTIFIES	M AO R T AH F AY Z
UNDEFILED	AH N D IY F AY L D
BRISTLECONE	B R IH S AH L K OW N
BLUESTEM	B L UW S T EH M
GLOWWORM	G L OW W ER M
ABRAMOFF	AE B R AH M AH F
HG	EY CH G
TATTED	T AE T IH D
THIRTYFIVE	TH ER T IY F AY V
DUGE	D Y UW JH
KAHLO	K AE L OW
DEMIGODS	D AH M IH G AH D Z
BARTENDER'S	B AA R T EH N D ER Z
GENTIANS	JH EH N CH AH N Z
HUMMED	HH AH M D
SEEMETH	S IY M IH TH
SLENDERNESS	S L EH N D ER N AH S
SAPPHO	S AE P OW
FARETH	F EH R IH TH
TEACHEST	T IY CH AH S T
KIRTLES	K AH R T AH L Z
TARANTULA'S	T AH R AE N CH UW L AH Z
SHYNED	SH AY N D
TREASON'S	T R IY Z AH N Z
BISECTED	B AY S EH K T IH D
LAUNFAL'S	L AO N F AH L Z
VANETTA'S	V AH N EH T AH Z
SCAVENGER'S	S K AE V AH N JH ER Z
SCATTER'D	S K AE T ER D
CLINKING	K L IH NG K IH NG
AONIAN	EY OW N IY AH N
SHINEST	SH AY N AH S T
UNDULATION	AH N JH AH L EY SH AH N
SEAHORSE	S IY HH AO R S
GUMBOOTS	G AH M B UW T S
FARTS	F AA R T S
WHARVES	W AO R V Z
SKYS	S K AY Z
PEEPER	P IY P ER
MIDMORN	M IH D M AH R N
RAIMENT	R EY M AH N T
KYRAT	K IH R AH T
BRAYING	B R EY IH NG
SOHRAB	S AA R AH B
REDEEMABLY	R IY D IY M AH B L IY
QUITRATUE	K W IH T R AH T UW
PALINGS	P EY L IH NG Z
BRESCIAN	B R EH SH AH N
COULDST	K OW AH L D S T
SKALD	S K AE L D
RAMEAU	R EY M IY UW
PROTEG	P R OW T EH G
GOMME	G AA M
DICTAEUS	D IH K T IY AH S
WH	D AH B AH L Y UW
RINGMOUNDS	R IH NG M AW N D Z
JOGGER'S	JH AA G ER Z
PIKELETS	P AY K L AH T S
JUICED	JH UW S T
EMPLOY'D	IH M P L OY D
SCRIPS	S K R IH P S
TAMELY	T EY M L IY
HOBOS	HH OW B OW Z
WHUMPP	W AH M P
HERMILDA'S	HH AH R M IH L D AH Z
WOULDN	W OW L D N
SHACK'S	SH AE K S
REGIMENTALS	R EH JH AH M AH N T AH L Z
UNBELIEV'D	AH N B AH L IY V D
OARSMEN	OW R S M AH N
IDES	AY D Z
SEEMLY	S IY M L IY
BLESSETH	B L EH S IH TH
MAYFLIES	M EY F L AY Z
INCOMPREHENSION	IH N K AA M P R IH HH EH N CH AH N
SANTOKA	S AE N T AH K AH
OPEING	OW P IY AH NG
GRISTLY	G R IH S T L IY
TARRIED	T AE R IY D
MORROWS	M AA R OW Z
DEEP'S	D IY P S
TREECUTTER	T R IY K AH T ER
ABANDONNED	AH B AE N D AH N D
TAMERS	T EY M ER Z
QUESTING	K W EH S T IH NG
NECKLINE	N EH K L AY N
CAMPOUT	K AE M P AW T
GAUNTLETS	G AO N T L AH T S
ZINGS	Z IH NG Z
LOVECAN	L AH V K AE N
UNSCREW	AH N S K R UW
PIERIDES	P AY R AY D Z
GLEANERS	G L IY N ER Z
OVID	AA V AH D
TOWHEE'S	T OW HH IY Z
FRIZ	F R IH Z
SCURRIES	S K ER IY Z
CANOPIED	K AE N AH P IY D
SYCAMORE'S	S IH K AH M AO R Z
CUNNINGLY	K AH N IH NG L IY
RIVULETS	R IH V Y AH L AH T S
POLYVINYLCHLORIDE	P OW L IY V AY N AH L K L OW R AY D
WATCHTOWER	W AA CH T AW ER
VERILY	V EH R IY L IY
SERAPHS	S EH R AH F S
PENITENCE	P EH N AH T AH N S
SHAM'D	SH AE M D
DISPUTANTS	D IH S P Y UW T AH N T S
HEARTSTRONG	HH AA R T S T R AO NG
BEASTLILY	B IY S T L IY L IY
HOARDER'S	HH OW R D AH R Z
RIPELY	R AY P L IY
ANTHURIUM	AE N TH UH R IY AH M
WHITEBAIT	W AY T B EY T
DOWNLAND	D AW N L AE N D
DELICIOUSNESS	D IH L IH SH AH S N AH S
DUSTUP	D AH S T AH P
PREEHAPS	P R IY EH HH AH P S
GOLONDRINA	G AH L AA N D R AH N AH
PRUNUS	P R UW N AH S
SAYEST	S EY AH S T
GARLANDS	G AA R L AH N D Z
XVIII	Z V IY IY
SERMONIZING	S ER M AH N AY Z IH NG
MINSTRELSY	M IH N S T R AH L Z IY
LICHFIELD	L IH CH IY L D
ARIOSTO	AE R IY AA S T OW
STARV'D	S T AA R V D
TATTOO'D	T AE T UW D
TEACUPS	T IY K AH P S
FLATBED'S	F L AE T B EH D Z
REINVOKE	R IY IH N V OW K
VOYAGING	V OY IH JH IH NG
STARSHINE	S T AA R SH AY N
SUPPLICATE	S AH P L AH K AH T
DRAGONFLY	D R AE G AH N F L AY
WONTED	W OW N T IH D
PUSH'D	P UH SH D
COUNTERCHANGED	K AW N T ER CH EY N JH D
DRIZZLED	D R IH Z AH L D
MUINLICHT	M UW N L AH CH T
PHILOLOGY	F AH L AA L AH JH IY
SIGISMUND	S AH JH IH Z M AH N D
TOWNY	T AW N IY
COSSIMBAZAR	K AA S IH M B AH Z AH R
MARZIO	M AA R Z IY OW
DICES	D AY S IH Z
YLDAN	Y L D AE N
YENSER	Y EH N Z ER
EEN	IY AH N
HYP	HH IH P
LAKEWIND	L EY K W IH N D
UNCTION	AH NG K SH AH N
HATLESS	HH AE T L AH S
NECESSITATEM	N EH S AH S IH T AH T AH M
TATSUKO'S	T AE T S UW K AH Z
PIEMAN	P AY M AE N
ADOWN	AH D AW N
PITTIE	P IH T IY
REFULGENT	R AH F UH L JH AH N T
MUIVE	M Y UW AH V
MUSKEG	M AH S AH G
ENCAMPS	EH N K AE M P S
DOOMSMAN'S	D UW M Z M AE N Z
VERSIFICATION	V ER S AH F AH K EY SH AH N
SEASCAPE	S IY S K EY P
BOARS	B OW R Z
CHISPA	CH IH S AH
SNARK	S N AA R K
HYACINTHINE	HH AY AE S AH N TH AY N
MENDACIOUSLY	M EH N D EY SH AH S L IY
DAMSONS	D AE M S AH N Z
WOOINGS	W UW IH NG Z
AMPLEST	AE M P AH L AH S T
WHIISKY	W IY S IY
SEMI'S	S EH M IY Z
HALLOW'S	HH AE L OW Z
STALACTITES	S T AE L AH K T AY T S
FREESIA'S	F R IY S IY AH Z
REASCEND	R IY AH S EH N D
STAMEN	S T EY M AH N
CLINKS	K L IH NG K S
OVERPRAISE	OW V ER P R EY Z
ASLUMBER	AH S L AH M B ER
FRUITFLIES	F R UW T F L AY Z
TEMPÊTE	T EH M P EH T EY
ENTREAT	EH N T R IY T
E'EN	EH AH N
OFYOU	AA F AY UW
SES	S
TYPOS	T IH P AH Z
SNOWON	S N OW AO N
FOGGING	F AA G IH NG
STOLES	S T OW L Z
BLUGGY	B L AH G IY
SHRILLING	SH R IH L IH NG
TURCOS	T AH R K AH Z
DRYADS	D R AY AH D Z
HEATHCLIFFS	HH IY TH L AH F S
CAROLING	K AE R AH L IH NG
FLOCK'S	F L AA K S
OBSEQUIES	AA B S AH K W IY Z
HEALER'S	HH IY L ER Z
CHRISTOPHEROS	K R IH S T AA F AH R AH Z
VAUNTING	V AO N T AH NG
BIRDLESS	B ER D L AH S
KNOWNOR	N OW N ER
SOFFSKY	S AA F S IY
THOUSANDFOLD	TH AW Z AH N D F OW L D
THRANG	TH R AE NG
TWOULD	T W OW L D
EALGIAN	EH L JH AH N
CATCOTT	K AE T AH T
CLANSMEN	K L AE N Z M EH N
APPEER'D	AE P AH R D
INTERUPTED	IH N T ER AH P T EH D
TRACKLESS	T R AE K L AH S
PUFFBALLS	P AH F B AO L Z
INGRATE	IH N G R EY T
QUARRELLED	K W AO R AH L D
TAIN'T	T EY N T
SILO'S	S AY L OW Z
SIZZLES	S IH Z AH L Z
SQUELCHES	S K W EH L CH IH Z
TRACINGS	T R EY S IH NG Z
PEKOE	P EH K OW
RUSTLED	R AH S AH L D
UNBLESSED	AH N B L EH S T
DUSKILY	D AH S K IY L IY
BLUEBIRD'S	B L UW B ER D Z
ALWAY	AE L W EY IY
TENDEREST	T EH N D ER AH S T
CAULD	K AO L D
HEARKEN	HH IH ER K EH N
SAMARRA	S AH M AE R AH
DITHYRAMBIC	D IH TH AH R AH M B AH K
THOLES	TH OW L Z
SOULLESSNESS	S OW L AH S N AH S
ZARINA	Z AE R AH N AH
WHING	W IH NG
LEORNIAN	L IY AO R N IY AH N
SD	EH S D
SYNE	S AY N
SIGHTLESS	S AY T L AH S
KYRAT'S	K AY R EY T S
SALLOW	S AE L OW
TUSCAN'S	T AH S K AH N Z
INCONDITIONS	IH N K AH N D IH SH AH N Z
HITHERWARD	HH AH TH AH R W AH R D
COWLED	K AW L D
HISAJO	HH IH S AH JH OW
COTTAGER	K AA T IH JH ER
FOURSCORE	F OW R S K OW R
DUNKING	D AH NG K IH NG
CALICANTUS	K AE L AH K AE N T AH S
SERGEANT'S	S AA R JH AH N TS
FISHERMEN'S	F IH SH ER M IH N Z
STORK'S	S T AO R K S
DUNCES	D AH N S AH Z
OBELISK	AA B AH L IH S K
SCOLLARD	S K AA L AH R D
SUNNIEST	S AH N IY AH S T
BUOY'S	B UW IY Z
SWADDLED	S W AA D AH L D
BEECHES	B IY CH IH Z
DEWPOINT	D UW P OY N T
GOLDENRODS	G OW L D AH N R AA D Z
STRINDBERG	S T R IH N D AH R G
RUNCIBLE	R AH N S AH B AH L
BEASTILY	B IY S T IY L IY
THUNDERHEAD	TH AH N D ER HH EH D
EVERGREEN'S	EH V ER G R IY N Z
PECS	P EH K S
TENDRILS	T EH N D R AH L Z
ASPHODEL	AE S AH D AH L
HARBINGE	HH AA R B AH N JH
FORDING	F OW R D IH NG
CUTTLEBONE	K AH T L AH B OW N
TRASHCAN	T R AE SH K AE N
SHOW'D	SH OW D
CENTURE	S EH N CH ER
GEOMETER	JH IY AA M AH T AH R
FOUNTS	F AW N T S
COQUETTISH	K OW K EH T IH SH
HAIJIN	HH EY JH AH N
WULLFLOOERS	W AH L F L UW AH R Z
CUBICAL	K Y UW B IH K AH L
FAUCHON	F AO CH AH N
BOOTETH	B UW T IH TH
BATYUSHKA	B AE T AY AH SH AH
MAMMON	M AE M AH N
ANEAR	AH N IH ER
WENCESLAS	W EH N S EH Z L AH Z
GLORY'S	G L AO R IY Z
CHICKADEES	CH IH K EY D IY Z
MAHJONG	M AE JH AH NG
DIVINES	D AH V AY N Z
TWINES	T W AY N Z
WARNYNGE	W AO R N AH N JH
DAFFODILLS	D AE F AH D AH L Z
ROUNDELAYS	R AW N D AH L EY Z
LAIUS	L EY AH S
WINDBLOWN	W IH N D B L OW N
PLUMPEST	P L AH M P AH S T
CORPOREAL	K AO R P OW R IY AH L
BESPRINKLED	B IH S P R IH NG K AH L D
WAGTAIL	W AE G T EY L
KOWHAI	K OW HH EY
PARTICIPATORS	P AA R T IH S AH P AH T ER Z
JAPH	JH AE F
WHITEOUTS	W AY T AW T S
SPEAKEST	S P IY K AH S T
HEAP'D	HH IY P D
XIV	Z IH V
DISPASSIONATENESS	D IH S P AE SH AH N AH T N AH S
INNUMEROUS	IH N UW M ER AH S
AWA	AO AH
SPLAYING	S P L EY IH NG
SWABBER	S W AA B ER
WHEREUNTO	W IY R UW N T OW
SUMI	S UW M IY
REASON'ST	R IY AE S AH N S T
TIMBERED	T IH M B ER D
ASTIR	AH S T ER
TACHOGRAPH	T AH CH AA G R AH F
WAIRMTH	W AE AH R M TH
DEVOIR	D AH V OY R
MIRIAM'S	M IH R IY AH M Z
SOUTHEY'S	S AW TH EY Z
JEWELLER'S	JH UW AH L ER Z
DROWSILY	D R AW Z IY L IY
UPRIGHTLY	AH P R AY T L IY
UNREACHED	AH N R IY CH T
JAMUN	JH AE M AH N
THUMBPRINT	TH AH M P R IH N T
PARSNIP	P AA R S N IH P
CLOSSSE	K L AA S
FILL'ST	F IH L S T
UNSEASONAL	AH N S IY Z AH N AH L
CURLEWS	K AH R L UW Z
CHERUBIM	CH EH R AH B IH M
MAGISTRATE'S	M AE JH AH S T R EY TS
CLAPPERLESS	K L AE P ER L AH S
OFSPRING	AA F S R AH NG
PERTAINETH	P ER T EY N IH TH
SUBTILE	S AH B T AY L
ZATTERE	Z AE T AH R
PREPROVE	P R IY P R UW V
OCTAVO	AA K T AH V OW
DISASSEMBLES	D IH S AH S EH M B AH L Z
SIGH'D	S AY D
RABBAN	R AE B AH N
SACKCLOTH	S AE K L AO TH
CROWNLESS	K R AW N L AH S
HEEDLESS	HH IY D L AH S
UNNECESSITATED	AH N IH S EH S AH T EY T IH D
EASIE	IY Z IY
REDDENING	R EH D AH N IH NG
WATERCOLORIST	W AO T ER K AH L ER IH S T
OBSIDERE	AA B S AH D AH R
BRIAREUS	B R AY AE R IY AH S
AAH	AA
PAPAIAPAX	P AH P EY AH P AH K S
VOMITS	V AA M AH T S
RAVENSTONE	R EY V AH N S T OW N
LAVED	L EY V D
UNBURIED	AH N B EH R IY D
LIETH	L AY IH TH
PALMETTOS	P AE L M EH T AH Z
EXHAUSTLESS	IH G Z AO S T L AH S
VANNES	V AE N Z
SUSANS	S UW Z AH N Z
EMBRASURE	IH M B R AE ZH Y AH R
FREESIAS	F R IY S IY AH Z
BAAL	B EY AH L
KESTREL'S	K EH S T R AH L Z
DOGES	D AO G Z
BRINISH	B R AY N AH SH
TRUMPET'S	T R AH M P AH TS
HIST	HH IH S T
WINGBEATS	W IH NG B IY T S
OLMEC	OW L M AH K
DISTANTLY	D IH S T AH N T L IY
DISSONATE	D IH S AH N AH T
UNFASHIONABLY	AH N F AE SH AH N AH B L IY
SHRINING	SH R AY N IH NG
UNBUTTONS	AH N B AH T AH N Z
TILLS	T IH L Z
UNFOULD	AH N F OW L D
BRITTLENESS	B R IH T AH L N AH S
OME	OW M
GESSO	JH EH S OW
METHODISTS	M EH TH AH D IH S T S
APPRECIATIONS	AH P R IY SH IY EY SH AH N Z
DIDN	D IH D N
HEAVINESS	HH EH V IY N AH S
JYLE	JH AY L
WITHAL	W IH TH AO L
PAVERS	P EY V ER Z
GOOOOOOD	G UW UW UW D
GAWAYNE	G AO EY N
VISORED	V IH Z ER D
KILDARE	K IH L D AH R
GOS	G OW Z
PLINKS	P L IH NG K S
STABLISHED	S T EY B AH L IH SH T
SKINNING	S K IH N IH NG
BIRTHDAY'S	B ER TH D EY Z
UNDERBELLIES	AH N D ER B EH L IY Z
FLOXGLOVES	F L AA K S G L OW V Z
MILKWHITE	M IH L K W AY T
SHES	SH IY Z
OCOTILLO	AA K AH T IH L OW
ORACULAR	AH R AH S Y AH L AH R
VIBRANCE	V AY B R AH N S
REPROVE	R IY P R UW V
NAPPY	N AE P IY
SINKFUL	S IH NG K F AH L
HERETO	HH EH R AH T OW
DIALECTICIANS	D AY AH L AH K T IH S IY AH N Z
OUR'SAILS	AW ER Z EY L Z
CONTRAILS	K AH N T R EY L Z
DROMOND'S	D R AA M AH N D Z
WREN'S	R EH N Z
NIGGUHS	N IH G AH Z
MINERVA'S	M AH N ER V AH Z
SOUNDLESS	S AW N D L AH S
SWATTING	S W AA T AH NG
MADAMS	M AE D AH M Z
NATHLESS	N AE TH L AH S
DALMANUTHA	D AE L M AE N AH TH AH
WASHROOMS	W AA SH R UW M Z
AKHILLEUS	AE K IH L IY AH S
AK	AE K
PRICK'D	P R IH K D
MIDSUMMER'S	M IH D S AH M ER Z
FIRSTLINGS	F ER S T L IH NG Z
HAINAULT	HH EY N AH L T
SEACLOGS	S IY K L AA G Z
DUSTINGS	D AH S T IH NG Z
FAMILAR	F EY M AH L AH R
SWANSONGS	S W AA N S AO NG Z
DUNNOCK'S	D AH N AH K S
EFFUSE	IH F Y UW Z
IRRECOVERABLY	IH R IH K AH V ER AH B L IY
MONSIGNORE	M AA N S IH G N AH R
ESP	EH S
LONELIEST	L OW N L IY AH S T
LOBBYS	L AA B IY Z
WHIPPOORWILL	W IH P UH R W IH L
UTE	Y UW T IY
HOMEBREW	HH OW M B R UW
ABSTEMIOUS	AE B S T IY M IY AH S
ROVES	R OW V Z
FIFES	F AY F S
HELLWARD	HH EH L W ER D
NOISELESS	N OY Z L AH S
MAZY	M EY Z IY
PINWHEEL	P IH N W IY L
HEEDE	HH IY D
UNSHED	AH N SH EH D
ESSENIAN	EH S IY N IY AH N
JEWELED	JH UW AH L D
SALUTATIONS	S AE L Y AH T EY SH AH N Z
SERTAYN	S AH R T EY N
STAIN'D	S T EY N D
CAPSIZES	K AE P S AY Z IH Z
STEEPS	S T IY P S
CAUNLES	K AO N AH L Z
CANDOLESCENT	K AE N D OW L S EH N T
MOPPSIKON	M AA P S AH K AH N
BROOKLET'S	B R UH K L AH T S
D'YOU	D AY UW
COCKERELS	K AA K EH R AH L Z
KHALIF	K HH AE L AH F
SENDEST	S EH N D AH S T
CHEATIN	CH IY T IH N
BREAST'S	B R EH S TS
ELYSIAN	AH L IH Z IY AH N
BROOKED	B R UH K T
INCHWORM'S	IH N CH W ER M Z
THRUMMING	TH R AH M IH NG
HEAV'N	HH IY V N
CONTINUO	K AH N T IH N Y AH W OW
CERI	S EH R IY
SHEDDAES	SH EH D EY Z
THROBS	TH R AA B Z
WOULDST	W OW L D S T
UNMOWN	AH N M OW N
WINDROWS	W IH N D R OW Z
LOOK'ST	L UH K S T
STRETCHIN	S T R EH CH IH N
LANIER'S	L AH N IH R Z
REMONSTRANCE	R IH M AA N S T R AH N S
ABEL'S	EY B AH L Z
WOMBS	W UW M Z
MOURNFULLY	M OW R N F AH L IY
SAGUAROS	S AE G W AH R AH Z
ÉMEUTES	EY M IY Y UW T S
O'ERFLOWS	AH AH R F L OW Z
SPARKLER	S P AA R K AH L ER
DAPPLED	D AE P AH L D
REPLY'S	R IH P L AY Z
JAMBALYA	JH AE M B AE L AY AH
VERTIGINOUS	V AH R T IH JH AH N AH S
AND'SCRATCHES	AE N D Z S K R AE CH IH Z
THUDS	TH AH D Z
REASON'S	R IY Z AH N Z
VANISH'D	V AE N IH SH D
NUDISTS	N UW D IH S T S
PARTWAY	P AA R T W EY
BINUKEDINE	B AY N Y UW K AH D AY N
POSSOM	P AA S AH M
QUIVERS	K W IH V ER Z
UNCONTAINABLE	AH N K AH N T EY N AH B AH L
OLLIER	AA L AY AH R
ONELY	OW N L IY
FANTASTICAL	F AE N T AE S T IH K AH L
FAMILIALE	F AH M IH L IY EY L
MOOSE'S	M UW S IX Z
EMBUED	IH M B Y UW T
TOPSAILS	T AA P S EY L Z
CHASSES	CH AE S AH Z
MORESCA	M AH R EH S AH
HACKY	HH AE K IY
UNSHARED	AH N SH EH R D
BEEHIVES	B IY HH AY V Z
ARROWY	AE R OW IY
MILTIADES	M IH L T IY EY D Z
BEARN	B AH AA R N
S'POSE	S P OW Z
IRIDESCENCE	IH R AH D EH S AH N S
DISCOURSING	D IH S K OW R S IH NG
LIMPID	L IH M P AH D
EDDIED	EH D IY D
PIKE'S	P AY K S
NIRVANNA	N AH R V AE N AH
TH'AFFLICTING	TH AE F L IH K T AH NG
MAAKU	M AA K UW
RAINWASHED	R EY N W AA SH T
UNFRIENDED	AH N F R EH N D IH D
SEGUES	S EH G Z
UMAYYAD	Y UW M EY AY AH D
AHAE	AE HH IY
NOCTURNE	N AA K T ER N
CONTRAINDICATIONS	K AA N T R AH IH N D AH K EY SH AH N Z
SUNRAYS	S AH N R EY Z
GLINTS	G L IH N T S
ANEMONES	AE N AH M OW N Z
GRAVEYARD'S	G R EY V Y AA R D Z
DRAPT	D R AE P T
RIFTED	R IH F T IH D
RINSED	R IH N S T
POICTIERS	P OY K T IY R Z
MERRIMENT	M EH R IY M AH N T
SANDCASTLES	S AE N D K AE S AH L Z
OUTFACES	AW T F EY S IH Z
WORSHIPPER	W ER SH AH P ER
IKONAS	IH K AH N AH Z
SHEEPBELLS	SH IY P B EH L Z
IGNOMINIOUSLY	IH G N AH M AH N IY OW AH S L IY
ANTEDATED	AE N T IH D EY T IH D
PARGA'S	P AA R G AH Z
WI	W IY
BARENESS	B EH R N AH S
OVERGROWS	OW V ER G R OW Z
UPREARS	AH P R IH ER Z
CUD	K AH D
LOVELL'S	L AH V AH L Z
WATERPOOLS	W AO T ER P UW L Z
INGRATITUDE	IH N G R AE T AH T UW D
ENGLISHMAN'S	IH NG G L IH SH M AH N Z
THIR	TH IH R
ALDERS	AE L D AH R Z
THISTLEDOWN	TH IH S T L AH D OW N
EMPRETZLED	IH M P R EH T S AH L D
FOREDECK	F OW R D EH K
AAAA	AA AH
UNEXCEPTIONAL	AH N IH K S EH P SH AH N AH L
MOULDED	M OW L D IH D
ASLANT	AH S L AE N T
ANSWERER	AE N S ER ER
TEAKETTLE	T IY K EH T AH L
CORTA	K AA R T AA
HORSEWOMAN'S	HH AO R S W UH M AH N Z
ALZHEIMERS	AE L Z HH IY M AH R Z
HIDEYHOLE	HH AY D IY HH OW L
KETTLE'S	K EH T AH L Z
SPIDER'S	S P AY D ER Z
RONDO	R AA N D OW
COCKCROWING	K AA K R OW IH NG
TELEGRAPHS	T EH L AH G R AE F S
SMOTE	S M OW T
HALFPIPE	HH AE F P AY P
UPTURNED	AH P T ER N D
ELD	EH L D
STEEPING	S T IY P IH NG
GRIPER	G R AY P ER
ELFLAND'S	EH L F L AH N D Z
HAYNE'S	HH EY N Z
SKINNYDIPPING	S K IH N IY D IH P IH NG
THEATRELIKE	TH IY AH T ER L AY K
SLUMBERED	S L AH M B ER D
PITEOUS	P IH T IY AH S
FOWLS	F AW L Z
PERFORM'D	P ER F AO R M D
WHIR	W ER
BEATIFIC	B IY AH T IH F IH K
CORIOLANUS	K OW R AY AA L AH N AH S
IVORIES	AY V AH R IY Z
BODNANT	B AA D N AH N T
TRAWLS	T R AO L Z
SAKURAS	S AE K Y AH R AH Z
LOVELIEST	L AH V L IY AH S T
DOETH	D OW IH TH
PSYOPS	S AY AH P S
IDIOT'S	IH D IY AH TS
BELLONA	B IH L AA N AH
ADVENTS	AE D V EH N T S
NETTLEBED	N EH T AH L B EH D
SLAVISHNESS	S L EY V IH SH N AH S
CHICKPEA	CH IH K P IY
DURATIONAL	D UH R EY SH AH N AH L
ASKEST	AE S K AH S T
FULFILS	F UH L F AH L Z
REGROUNDING	R IY G R AW N D IH NG
ALLELUIAS	AE L EH L UW AH Z
FIORDISPINA	F AY AH R D IH S AH N AH
MUFFET	M AH F AH T
APPARTMENT	AE P AA R T M AH N T
KILLDEER	K IH L D IH ER
NANNIE	N AE N AY
BOOT'S	B UW TS
DREE	D R IY
DÉCOLLETÉ	D EY K AA L AH T EY
FOUNDATIONLESS	F AW N D EY SH AH N L AH S
TELST	T EH L S T
PANGAEA	P AE N G IY AH
FLIPFLOP	F L IH P F L AA P
ECCLESIASTES	EH K L IY S IY AH S T S
ATTEMPERED	AE T AH M P IY R D
EDWINYANES	EH D W IH N AY EY N Z
ROAMER	R OW M ER
UNTETHERED	AH N T EH DH ER D
SIDESLIPS	S AY D S L IH P S
INFINITUDE	IH N F AY N AH T UW D
CRISSE	K R IH S
HRUCK	HH R AH K
PHILLPOTTS	F IH L P AH T S
WAGTAIL'S	W AE G T EY L Z
ENVEIL	EH N V EY L
MULK	M UH K
RESIGNEDLY	R IH Z AY N AH D L IY
GRAVEDIGGER	G R EY V D IH G ER
PAPYRUS	P AE P AH R AH S
HYBLAEAN	HH IH B L IY AH N
GONGWANG	G AA N G W AH NG
TOTTERED	T AA T ER D
HOODOOS	HH UW D UW Z
BEDSORE	B EH D S OW R
HOCHE	HH AA CH
GINKGO'S	G IH NG K OW Z
TOLMAN'S	T AA L M AH N Z
TREADLE	T R IY D AH L
MAYEST	M EY AH S T
WRESTLINGS	R EH S T L IH NG Z
M'LADY'S	M L AE D AH Z
CUSPS	K AH S P S
SUFFOCATES	S AH F AH K EY T S
SHHH	EH S EY CH EY CH
FLIMMER	F L IH M AH R
SUFFERANCE	S AH F ER AH N S
ROSSETTI'S	R OW S EH T IY Z
TEMPESTS	T EH M P AH S T S
SQUINTS	S K W IH N T S
MELITA'S	M EH L IY T AH Z
BARBARELLA	B AA R B AH R EH L AH
ROOTMASS	R UW T M AE S
RD	AA R D
WHELM	W EH L M
NAIN	N EY N
GAMER'S	G EY M ER Z
SHOVELY	SH AH V L IY
PLIGHTED	P L AY T IH D
ALIT	AH L IH T
TEAHOUSE	T IY HH AW S
PARASOL	P AE R AH S AO L
SUBSTANCELESS	S AH B S T AH N S L AH S
BLOWFLY	B L OW F L AY
MEMLING	M EH M L AH NG
PREFERRD	P R IY F EH R D
UPRAISED	AH P R EY Z D
STRAIGHTWAY	S T R EY T W EY
SOUNDOF	S AW N D AH F
UNGARBLED	AH N G AA R B AH L D
LONELILY	L OW N L IY L IY
SANGAR	S AE NG ER
BETHINK	B IH TH IH NG K
ERROR'S	EH R ER Z
HYDROZOAN	HH IH D R AA Z OW AH N
EXCEPTIONABLY	IH K S EH P SH AH N AH B L IY
UNATTAINTED	AH N AH T EY N T EH D
BYSSHE	B IH S
O'ERTAKING	AA AH R T EY K AH NG
JAPHET	JH AE F AH T
GLASSBLOWER'S	G L AE S B L OW ER Z
RECOMPENSED	R EH K AH M P EH N S T
VOUCHSAFED	V AW CH S EY F T
RECESSIONALS	R IY S EH SH AH N AH L Z
THRO	TH R OW
WAVE'S	W EY V Z
DUOMO	D Y UW AH M OW
FORENOON	F OW R N UW N
LOOSEKNIT	L UW S N IH T
SHAMAN'S	SH EY M AH N Z
CORNFLAKES	K AO R N F L EY K S
INWROUGHT	IH N R AO T
MIDDLEAGED	M IH D AH L IH JH D
STOVEPIPE	S T OW V P AY P
LADYSHIP'S	L EY D IY SH IH P S
WELTERED	W EH L T ER D
TRAWLER'S	T R AO L ER Z
FORGETFULNESS	F AO R G EH T F AH L N AH S
CYCLAMENS	S IH K L AH M AH N Z
USURER	Y UW ZH ER ER
SHEEPFOLD	SH IY P F OW L D
KNAVISH	N EY V AH SH
TORDENSKIOL	T AO R D EH N S IY AH L
PEKAN	P IY K AH N
BOATMAN'S	B OW T M AH N Z
COVER'D	K AH V ER D
POKEBERRY	P OW K B EH R IY
PUSSYWILLOWS	P UH S IY W IH L OW Z
HOTOTOGISU	HH AA T AH T AA JH AH S UW
STARLESS	S T AA R L AH S
WHITECAPS	W AY T K AE P S
NURST	N AH R S T
WELKIN	W EH L K AH N
PACIFC	P AE S AH F
WUT	W AH T
THOU'RT	TH AW R T
HELLHOUND'S	HH EH L HH AW N D Z
DIPPER'S	D IH P ER Z
VENTRILOQUIST	V EH N T R AH L AA K W AH S T
GRASSHOPPER'S	G R AE S HH AA P ER Z
WINTERIZING	W IH N T ER AY Z IH NG
SWALLOW'S	S W AA L OW Z
DOUCEREUX	D AW S IY R IY AH K S
EAGLETS	IY G L AH T S
HATCHLINGS	HH AE CH L IH NG Z
FAMILIARS	F AH M IH L Y ER Z
FOREBODES	F OW R B OW D Z
BOTTLEBRUSH	B AA T AH L B R AH SH
VOL	V AA L
PEARLED	P ER L D
CADAVARENA	K AE D AH V AE R AH N AH
PANTHEISM	P AE N DH IY IH Z AH M
DEER'S	D IH R Z
MERCY'S	M ER S IY Z
COUPLET	K UW L AH T
SPIDERLINGS	S P AY D ER L IH NG Z
SPEARMINT	S P IH ER M IH N T
SKIMS	S K IH M Z
CUMBROUS	K AH M B R AH S
WILLOWTIP	W IH L OW T IH P
GRANDCHILD'S	G R AE N D CH AY L D Z
TONGUELESS	T AH NG L AH S
SALT'S	S AO L TS
INGELD	IH N G EH L D
TOOLSHED	T UW L SH EH D
KABE	K EY B
FOGHORNS	F AA G HH AO R N Z
RENDS	R EH N D Z
ROTHKO'S	R AA TH AH Z
TIRESIAS	T AH R IY S IY AH Z
SURFCASTER'S	S ER F K AE S T ER Z
ENCHANTRESS	IH N CH AE N T R AH S
CAMERADO	K AE M R AH D UW
SPINNED	S P IH N D
PIONT	P AY AH N T
WINDOWSILL	W IH N D OW S IH L
TYDEUS	T AY D IY AH S
PINKING	P IH NG K IH NG
VENT'ROUS	V EH N T R AH S
FORESPENT	F OW R S P EH N T
CLACKING	K L AE K AH NG
OSPREY'S	AO S P R IY Z
TRICOLOR	T R AY K AH L ER
IMMOD'RATE	IH M AA D R EY T
LOITERS	L OY T AH R Z
CHUCHOTANT	CH AH CH AH T AH N T
SUSURRUS	S UW S AH R AH S
PRINCEPS	P R IH N S AH P S
ORIONS	OW R IY AH N Z
FLUTING	F L UW T IH NG
NEWBOLT	N UW B OW L T
SEEMEST	S IY M AH S T
UNEXPERT	AH N EH K S P ER T
LICHENED	L AH CH IY N D
THYRSIS	TH IH R S AH S
HONEYED	HH AH N IY D
GOSUDAR	G AH S UW D AH R
MERDS	M AH R D Z
CHAINSMOKING	CH EY N S M OW K IH NG
REDPOLL'S	R EH D P OW L Z
LIGHTSPEED	L AY T S P IY D
DUSKS	D AH S K S
GADES	G EY D Z
PROWLS	P R AW L Z
SATURATES	S AE CH ER AH T S
EXCRESCENCE	EH K S K R EH S AH N S
FLASH'D	F L AE SH D
SUFFICETH	S AH F AY S IH TH
HOKUSAI'S	HH AA K Y AH S EY Z
EDENIC	EH D AH N AH K
TOURGUIDE	T UH R G AY D
CARKING	K AA R K IH NG
DOLOMPHIOUS	D AH L AA M F IY AH S
WASSAILER	W AH Z EY L ER
DOVETAILING	D AH V T EY L IH NG
ADJ	AE JH
IX	IH K S
SLUMBERS	S L AH M B ER Z
LUCRETIUS	L AH K R EH T AY AH S
T'AI	T EY
UNSTRICKEN	AH N S T R IH K AH N
BETOKENED	B IH T OW K AH N D
LATTICED	L AE T AH S T
BOYHOOD'S	B OY HH UH D Z
ROPEY	R OW P IY
UNPAIRED	AH N P EH R D
JEW'S	JH UW Z
DARKLING	D AA R K L IH NG
UNBRAID	AH N B R EY D
SIREN'S	S AY R AH N Z
WHIPPOORWILL'S	W IH P UH R W IH L Z
HARBOURLESS	HH AA R B AH Y UH R L AH S
WALLBANGERS	W AO L B AE NG ER Z
PRON	P R AA N
LYNCUS	L IH NG K AH S
SHOESHINER'S	SH UW SH AY N ER Z
JUNIPER'S	JH UW N AH P ER Z
RIFFLES	R IH F AH L Z
RASCALIEST	R AE S K AH L IY AH S T
CENTERLINE	S EH N T ER L AY N
FOREKNEW	F OW R N UW
VISAKHA	V AH S AE K AH
SOWETH	S AW IH TH
MONKISH	M AH NG K IH SH
WALLSTEAD	W AO L S T EH D
BLISSES	B L IH S IH Z
GANNET	G AE N AH T
PRS	P IY AA R S
RILKE	R IH K
SQUIRRELWAYS	S K W ER AH L W EY Z
MACROCARPA	M AE K R AH K AA R P AH
SCORIA	S K AO R IY AH
SUNNED	S AH N D
WHITENED	W AY T AH N D
THEREABOUT	TH IY R AH B AW T
DISENSLAVE	D IH S EH N S L EY V
ESSENIANS	EH S IY N IY AH N Z
REOCCURRENCE	R IY AH K ER AH N S
SIGHETH	S AY IH TH
SWALING	S W EY L AH NG
ROUSHAN	R AW SH AH N
ACCUSER'S	AH K Y UW Z ER Z
DELANTE	D AH L AE N T
KADDISH	K AA D IH SH
PULPMILL	P AH L P M IH L
GAULEY	G EY AH L IY
TIPTOES	T IH P T OW Z
CROSSBAR	K R AO S B AA R
GOGH'S	G OW Z
MOONLESSNESS	M UW N L AH S N AH S
TRAIL'S	T R EY L Z
TOUCHMADE	T AH CH M EY D
PANSY'S	P AE N Z IY Z
PATHFINDERS	P AE TH F AY N D ER Z
GRIEF'S	G R IY F S
ALIGHTING	AH L AY T IH NG
SHADOWLESS	SH AE D OW L AH S
SOUNDLESSLY	S AW N D L AH S L IY
RAILBED	R EY L B EH D
ONDS	AA N D Z
SPRAY'S	S P R EY Z
LOON'S	L UW N Z
ROUNDNESS	R AW N D N AH S
PTARMIGAN	T AA R M AH G AH N
KNIFE'S	N AY F S
RUGOSA	R UW G AH S AH
ELEND	EH L AH N D
CRABAPPLE	K R AE B AE P AH L
PRATTLERS	P R AE T L AH R Z
YELLOWED	Y EH L OW D
GATOR'S	G EY T ER Z
BLUETIT	B L UW T IH T
JELLYBEANS	JH EH L IY B IY N Z
THRONGING	TH R AO NG IH NG
BLINDFOLDS	B L AY N D F OW L D Z
HASTENEST	HH EY S AH N AH S T
HOUSEMAID	HH AW S M EY D
WAGTAILS	W AE G T EY L Z
SHREDTHE	SH R EH D
PETTIEST	P EH T IY AH S T
CANNIBALISTICALLY	K AE N AH B AH L IH S T IH K AH L IY
BEREAVEN	B IH R IY V AH N
APPANAGE	AE P AH N IH JH
RIVULET	R IH V Y AH L AH T
SHENDING	SH EH N D AH NG
CAMELLIA	K AH M IY L Y AH
BEHOLDS	B IH HH OW L D Z
JINGLING	JH IH NG G AH L IH NG
BRUSHSTROKES	B R AH SH S T R OW K S
GAYLY	G EY L IY
UNINTELLIGENCE	AH N IH N T EH L AH JH AH N S
UNBARRED	AH N B AA R D
MAKETH	M EY K IH TH
SILVERBERRY	S IH L V ER B EH R IY
INTROITUS	IH N T R OY T AH S
HELLENIUS	HH EH L EH N AY AH S
OBOVE	AH B OW V
CLOUDCAST	K L AW D K AE S T
AROON	AH R UW N
REMOTER	R IY M OW T ER
UNFATHOMED	AH N F AE DH AH M D
PLUMED	P L UW M D
PREPONDERATES	P R IY P AA N D ER AH T S
VAINGLORY	V EY N G L OW R IY
FIRELIGHT	F AY ER L AY T
CYPRIPE	S IH P R AY P
WOLFISH	W UH L F IH SH
DECEMVIRS	D AH S EH M V AH R Z
TAKLAMAKAN	T AE K L AE M AH K AH N
DEEPS	D IY P S
PLATEAUS	P L AE T OW Z
GORGED	G AO R JH D
MOWN	M OW N
LEPT	L EH P T
THEREFROM	DH AE R F R AH M
REDOUTABLE	R EH D AW T AH B AH L
NAHMA	N AE M AH
FLOW'R	F L OW R
HARDHAT	HH AA R D HH AE T
BREAKFASTLESS	B R EH K F AH S T L AH S
YOGIS	Y OW G IY Z
HUSBANDMAN	HH AH Z B AH N D M AE N
PHLOX	F L AA K S
DARKSOME	D AA R K S AH M
STATUE'S	S T AE CH UW Z
TOOTHLESSLY	T UW TH L AH S L IY
F'R	EH F R
INTÉRIEUR	IH N T EY R Y UW R
PEETOOKLE	P IY T AH K AH L
REDDNESS	R EH D N AH S
JOCUND	JH AA K AH N D
PENDENT	P EH N D EH N T
LAOTIANS	L EY OW T IY AH N Z
DARGLE	D AA R G AH L
INCOMMENSURATE	IH N K AH M EH N S AH R AH T
GYT	JH IH T
POUR'D	P OW R D
REPROVETH	R IY P R UW V IH TH
CLEAVING	K L IY V IH NG
SEEST	S IY AH S T
DOVEFEEDING	D AH V F IY D IH NG
SHRIKE'S	SH R AY K AH Z
GROSPHUS	G R AA S AH S
BITTERN	B AY T AH R N
WINTERSCAPE	W IH N T ER S K EY P
COLADA	K OW L AE D AH
WARRIGABORRIGAROOMA	W AO R AH G AH B AO R AH G AH R UW M AH
MOVELESS	M UW V L AH S
WHIRS	W ER Z
SILENUS	S IH L AH N AH S
GROOM'S	G R UW M Z
VIII	V IY IY
MEDAL'S	M EH D AH L Z
TÉGÉNAIRES	T EY G EY N AE AH R Z
SUNDOGS	S AH N D AO G Z
CLASPS	K L AE S P S
NEWBORN'S	N UW B AO R N Z
AFTERBIRTH	AE F T ER B ER TH
TWITTERING	T W IH T ER IH NG
GEWYRCEAN	JH UW AH R S IY AH N
STINKER	S T IH NG K ER
COVETING	K AH V AH T IH NG
DUNGHILL	D AH NG HH IH L
SKELTON'S	S K EH L T AH N Z
SILOAM'S	S AH L OW M Z
CORDGRASS	K AO R D G R AE S
UNPREDICTED	AH N P R IH D IH K T IH D
FLAILS	F L EY L Z
BIRDQUAKE	B ER D K W EY K
SNUFFBOX	S N AH F B AA K S
REGIFTED	R IY G IH F T IH D
TUNIC'S	T UW N IH K S
SUNSTREAMS	S AH N S T R IY M Z
ANATHEMATIZED	AE N AH TH EH M AH T AY Z D
ROLLIES	R OW L IY Z
CALLIGRAPHERS	K AH L IH G R AH F ER Z
CAWS	K AO Z
JASMINES	JH AE Z M AY N Z
PIGTAILED	P IH G T EY L D
PECKED	P EH K T
WOMENS	W IH M AH N Z
SIDELONG	S AY D L AO NG
WOODBINE	W UW D AY N
SEPULCHRE	S EH P AH L K ER
FROLICSOME	F R AA L IH K S AH M
BEANSTALKS	B IY N S T AO K S
SECU	S EH K UW
COMMISERATION	K AH M IH Z ER EY SH AH N
SEEK'ST	S IY K S T
SNAKESKIN'S	S N EY K S K IH N Z
MORISCO	M AH R IH S OW
URBINO	AH R B AH N OW
REDDENS	R EH D AH N Z
SCARFING	S K AA R F IH NG
MILKFLOWER	M IH L K F L AW ER
POETESSES	P OW AH T AH S IH Z
FURLED	F ER L D
REMAINETH	R IH M EY N IH TH
WHEEL'S	W IY L Z
RETURNEST	R IY T ER N AH S T
CLEARWING'S	K L IH ER W IH NG Z
FLICKER'S	F L IH K ER Z
WHERESOE'ER	W EH R AH S OW AH AH R
CONFESSOR	K AH N F EH S ER
LOVESONG	L AH V S AO NG
AGITATES	AE JH AH T EY T S
LIGN	L IH N
RAVISHED	R EY V IH SH T
GALLANTS	G AE L AH N T S
BETROTHAL	B IH T R AO TH AH L
CICADA'S	S AH K EY D AH Z
ROSÉ	R AA Z EY
EPIGRAPH	EH P AH G R AE F
LIBERATES	L IH B ER AH T S
HALYARD	HH AE L AY AH R D
UNBURTHEN	AH N B AH R TH AH N
BETIMES	B IH T AY M Z
THESSALIA'S	TH EH S EY L Y AH Z
REDSTART	R EH D S T AA R T
SLEEPDRUNK	S L IY P D R AH NG K
WINGLESS	W IH NG L AH S
CARTHUSIAN	K AA R TH AH S IY AH N
NOO	N UW
JAR'S	JH AA R Z
TWELVEMONTH	T W EH L V M AH N TH
TUM	T AH M
PENINSULAS	P AH N IH N S AH L AH Z
BREEKS	B R IY K S
MILLPOND	M IH L P AA N D
ACADIANS	AH K EY D IY AH N Z
STALLION'S	S T AE L Y AH N Z
HOROLOGE	HH AO R AH L OW JH
MACHU	M AE CH UW
THAR'S	TH AA R Z
UNBURDENABLE	AH N B ER D AH N AH B AH L
ENDEVORD	IH N D AH V AO R D
ALOW	AH L OW
FLOODLIT	F L AH D L IH T
THURINGIA'S	TH AH R IH N JH IY AH Z
LABOURER	L EY B ER ER
GIORGIONE	JH AY AO R JH IY OW N
CLOCKTOWER	K L AA K T AW ER
RETURNETH	R IY T ER N IH TH
COLLAR'S	K AA L ER Z
ETHERIZED	IY TH ER AY Z D
TARGATS	T AA R G EY T S
WHETS	W EH T S
SNIPPING	S N IH P IH NG
WRATHFUL	R AE TH F AH L
ORCHID'S	AO R K AH D Z
DREAMCATCHER'S	D R IY M K AE CH ER Z
DIGHT	D AY T
UNILINGUAL	Y UW N IH L IH NG G W AH L
DRIPPINGS	D R IH P IH NG Z
SUET	S UW AH T
LARKSONG	L AA R K S AO NG
POPLARS	P AA P L ER Z
WAKENED	W EY K AH N D
BOARDWALKING	B OW R D W AO K IH NG
FRIENDSHIP'S	F R EH N D SH IH P S
SPECTRES	S P EH K T ER Z
SOVERNEIGNTY	S AA V AH R N EY N T IY
ANALGESIA	AE N AH L JH IY ZH IY AH
PENCILLED	P EH N S AH L D
DEIGNEST	D EY N AH S T
HUMLESS	HH AH M L AH S
O'ERCAME	AA AH R K EY M
BARBAROSSA	B AA R B AH R AA S AH
TOLLUND	T AA L AH N D
BULRUSHES	B UH L R AH SH AH Z
RECED	R IY S T
WINTERING	W IH N T ER IH NG
GOSKY	G OW S K AY
COWSLIPS	K AW S L IH P S
VERDIGRIS	V AH R D IH G R AH S
DRAKE'S	D R EY K S
POUNCES	P AW N S AH Z
FOGHORN	F AA G HH AO R N
GRIEFS	G R IY F S
EID'S	AY D Z
SWAN'S	S W AA N Z
CAVEMEN	K EY V M EH N
PUMKINS	P AH M K AH N Z
EXHALING	EH K S HH EY L IH NG
COCKEREL	K AA K EH R AH L
MARCHESA	M AA R K AH S AH
ERHU	EH R UW
DISENTHRAL	D IH S IH N TH R AO L
KAWEEN	K AO IY AH N
BARNWOOD	B AA R N W UH D
CONFORMATION	K AA N F AO R M EY SH AH N
EARE	IY R
BRENNE	B R EH N
WAVERS	W EY V ER Z
HORNBEAM	HH AO R N B IY M
HARDIHOOD	HH AA R D IY HH UH D
NIETH	N AY AH TH
HARDON	HH AA R D AO N
KNOWETH	N OW IH TH
ESDAILE	EH Z D EY AH L
ARRANG'D	AE R AH N G D
HIVING	HH AY V IH NG
LYNMOUTH	L IH N M AW TH
FIDDLEHEADS	F IH D AH L HH EH D Z
EIGHTSCORE	EY T S K OW R
CARAPACE	K AA R AH P EY S
CASEMENT	K EY S M AH N T
CAMPHOR	K AE M F AH R
KILOTON	K IH L AH T AH N
SARDANAPALUS	S AA R D AH N AE P AH L AH S
SWAINS	S W EY N Z
PONARY	P OW N AH R IY
KARELA	K AE R AH L AH
MAIDENHEAD	M EY D AH N HH EH D
SPECKLES	S P EH K AH L Z
DESTROYEST	D IH S T R OY AH S T
MONGREL	M AA N G R AH L
GUT'S	G AH TS
DEBAUCH	D AH B AO CH
THEWS	TH UW Z
HORIZONLESS	HH AH R AY Z AH N L AH S
SUNBEAMS	S AH N B IY M Z
SHEPERDS	SH EH P AH R D Z
LIVELONG	L IH V L AO NG
POWLONIA	P OW L OW N Y AH
DWARFISH	D W AO R F IH SH
RELIGHT	R IY L AY T
GLADDENED	G L AE D AH N D
ICYCLES	IH S AH K AH L Z
BAIRAGI	B AE AH R AH JH IY
TUMULUS	T Y UW M Y AH L AH S
PATTERING	P AE T ER IH NG
ENDURABLE	EH N D UH R AH B AH L
ENCELADUS	IH N S EH L AH D AH S
DECOCTIONS	D AH K AH K T AY AH N Z
GIBBOUS	JH IH B AH S
SNOWMAN'S	S N OW M AE N Z
TRY'D	T R AY D
VIENDRAIT	V IY N D R EY T
GARGOYLED	G AA R G OY L D
STRAL	S T R AE L
KNELLS	N EH L Z
BEWAIL	B IH W EY L
BEGIRT	B AH JH AH R T
ENLARG'D	IH N L AA R G D
HONIED	HH OW N IY D
FLYTHESE	F L AH TH IY Z
TUSSOCKS	T AH S AH K S
MAY'ST	M EY S T
CLATTERS	K L AE T ER Z
NOUGHT	N AO T
JAWBONES	JH AO B OW N Z
ANT'S	AE N TS
MUSTANG'S	M AH S T AE NG Z
ROADSTEAD	R OW D S T EH D
MIGRANT'S	M AY G R AH N TS
SUPPLIANT	S AH P L AY AH N T
CURA	K Y UH R AH
RANTS	R AE N T S
UNFURLINGS	AH N F Y UH R L IH NG Z
SWATS	S W AA T S
KV	K EY V
PENCLAWDD	P EH NG K L AH D
BEGGAR'S	B EH G ER Z
CONSOLER	K AH N S OW L ER
DIPLAY	D IH P L EY
MOUSE'S	M AW S IX Z
OVERBOLD	OW V ER B OW L D
STEADIES	S T EH D IY Z
GRIS	G R IH Z
STONEWALL'S	S T OW N W AO L Z
JOVE	JH OW V
SOGGARTH	S AA G AH R TH
TARDIS	T AA R D IY Z
SENESCHALS	S AH N EH S AH L Z
ALMONERS	AE L M AH N AH R Z
SHOVEL'S	SH AH V AH L Z
TITMOUSE	T IH T M AW S
IMMERSES	IH M ER S IH Z
MAUSERED	M AH S IY R D
ISCHIA	IH S IY AH
CHAPELS	CH AE P AH L Z
LETHE'S	L EH DH AH Z
THANGBRAND	TH AE N G R AH N D
FIREPIT	F AY ER P IH T
LT	EH L T
GAMBOL	G AE M B AH L
DOUBLET	D AW B L AH T
ALEXANDRIAN	AH L EH K S AE N D R IY AH N
BROOKLETS	B R UH K L AH T S
PERSEPHONE	P AH R S AH F OW N
CUPID'S	K Y UW P IH D Z
SLUG'S	S L AH G Z
DAYSPRING	D EY S P R IH NG
MAILMAN'S	M EY L M AE N Z
ALLHALLOWS	AO L HH AE L OW Z
SEAWALL	S IY W AO L
RESOUNDS	R IY S AW N D Z
VERWANDERLUNG	V AH R W AH N D AH R L AH NG
LIFELESSNESS	L AY F L AH S N AH S
STRANGLER'S	S T R AE NG G L ER Z
DISHWATER	D IH SH W AO T ER
HERES	HH IH ER Z
FLEDGLINGS	F L EH JH L IH NG Z
TOROS	T AO R AH Z
CARIES	K EH R IY Z
FOREGATHER	F OW R G AE DH ER
CROWN'ST	K R OW N S T
GRAFTINGS	G R AE F T IH NG Z
SLICKNESS	S L IH K N AH S
BEACHGOERS	B IY CH G OW ER Z
MORRN	M AO R N
GREYFRIAR'S	G R EY F R AY ER Z
BOWERBIRD	B AW ER B ER D
MELHAM	M EH L HH AH M
FALLUJA	F AE L UW JH AH
DREST	D R EH S T
STRUGGLEST	S T R AH G AH L AH S T
COVETOUS	K AH V AH T AH S
STARLINGS	S T AA R L IH NG Z
METRONOME	M EH T R AH N OW M
MARCHÉ	M AA R CH EY
LAPWINGS	L AE P W IH NG Z
HANDPRINTS	HH AE N D P R IH N T S
CHOIRING	K W AY ER IH NG
MAGPIE'S	M AE G P AY Z
INDOLENTLY	IH N D AH L AH N T L IY
OBELISKS	AA B AH L IH S K S
HUNH	HH AH N
THROBBED	TH R AA B D
GLADSOME	G L AE D S AH M
GREENSWARD	G R IY N S W AO R D
INTERWOVE	IH N T ER W OW V
BLIGHTING	B L AY T IH NG
HONEYBEE'S	HH AH N IY B IY Z
CHACHALACAS	CH AH CH AE L AH K AH Z
ALEMBIC	AE L AH M B AH K
MENDS	M EH N D Z
UNCOUNTABLE	AH N K AW N T AH B AH L
TYROLS	T IH R AH L Z
APENNINES	AH P EH N AY N Z
ARTIFICER	AA R T AH F AH S ER
PARAPHRASES	P AE R AH F R EY Z IH Z
COM'ST	K AA M S T
WHIRLWINDS	W ER L W IH N D Z
GASWORKS	G AE S W ER K S
OJIBWE	AA JH AH B W
SONGMAN	S AO NG M AE N
QUARTERED	K W AO R T ER D
PHANTASMAL	F AE N T AE Z M AH L
RAIMENT'S	R EY M AH N T S
ROSEBRIGHT	R OW Z B R AY T
TROUBLOUS	T R AH B AH L AH S
TARE	T AE R
BAG'S	B AE G Z
SAWN	S AO N
SALAAMS	S AE L AH M Z
SANGOMO	S AE N G AH M OW
CHUNTERING	CH AH N T IY R AH NG
SCHOOLKIDS	S K UW L K IH D Z
LEATHERN	L IY TH AH R N
RIVERSTONE	R IH V ER S T OW N
WEET	W IY T
LEAVED	L IY V D
YE'LL	Y IY L
BLYSSE	B L IH S
FLATLINE	F L AE T L AY N
WHELPS	W EH L P S
DISUNITE	D IH S Y UH N AY T
MOORHEN'S	M UH R HH EH N Z
RHYTHEM	R IH TH AH M
STOAT	S T OW T
NOBLENESS	N OW B AH L N AH S
WATERBIRDS	W AO T ER B ER D Z
DANDLES	D AE N D AH L Z
KINK	K IH NG K
MAXIMALLY	M AE K S IY M AE L IY IY
CREATION'S	K R IY EY SH AH N Z
FEIGN'D	F EY N D
SEAFROTH	S IY F R AO TH
SUCCOURLESS	S AH K AH Y UH R L AH S
ECSTATICS	EH K S T AE T IH K S
THUNDERER	TH AH N D ER ER
GLAZ'D	G L AE Z D
CLENCHING	K L EH N CH IH NG
MAINMAST	M EY N M AE S T
FOREORDAINED	F OW R AO R D EY N D
ONLYS	AO N L IY Z
TWIXT	T W IH K S T
TRUCKER'S	T R AH K ER Z
AFFRIGHTING	AE F R AY T AH NG
FEARIN	F IH ER IH N
WHITTLES	W IH T AH L Z
SWINBURNE	S W IH N B AH R N
UNAIMED	AH N EY M D
LIBERTAD	L AH B AH R T AH D
AWL	AO L
PECKS	P EH K S
HYDRANGEAS	HH IH D R AE N JH IY Z
EVANGEL	IH V AE N JH AH L
COPPERTONE	K AA P ER T OW N
HEALINGS	HH IY L IH NG Z
POW'R	P OW R
MORTMAIN	M AO R T M EY N
REVENGEFUL	R IY V EH N JH F AH L
ASSAI	AA S AY
OUCH'D	AW CH D
PRANCED	P R AE N S T
DEARS	D IH ER Z
AMETAS	AE M AH T AH Z
MULLIONS	M AH L Y AH N Z
SERFDOM	S ER F D AH M
SURFEITING	S ER F AH T IH NG
MANNAHATTA	M AE N AH HH AE T AH
SCEOLDE	S IY OW L D
SUPERMOON	S UW P ER M UW N
INCONSEQUENCE	IH N K AA N S AH K W AH N S
SIO	S AY OW
R'SUM	R S AH M
UNHEEDING	AH N HH IY D IH NG
BLIGHTY	B L AY T IY
OMMMMM	AA M
ANGELHEADED	EY N JH AH L HH EH D IH D
WHOS	HH UW Z
BELFRY'S	B EH L F R IY Z
STELES	S T IY L Z
SWAMPCUNT	S W AA M P AH N T
HUCKLEBERRIES	HH AH K L AH B EH R AY Z
PROJECTOR'S	P R AA JH EH K T ER Z
STRENGTHY	S T R EH NG TH IY
BOBS	B AA B Z
JUAN'S	W AA N Z
UNREGARDFUL	AH N R IH G AA R D F AH L
CARIAN'S	K AE R IY AH N Z
ABYDOS	AH B AY D UW Z
UNLACE	AH N L EY S
COSIMO	K OW S IH M OW
STEELTOWN	S T IY L T AW N
SHOOS	SH UW Z
BOUNCEBACK	B AW N S B AE K
CLOUDLETS	K L AW D L AH T S
MANTLING	M AE N T AH L IH NG
CUMMERBUND	K AH M AH R B AH N D
EIDERS	IY D AH R Z
BARN'S	B AA R N Z
DEWED	D IY W EH D
TADS	T AE D Z
UNDERTALKS	AH N D ER T AO K S
SIMPLETON	S IH M P AH L T AH N
PEALED	P IY L D
SFERO	S F EH R OW
THATS	DH AE T S
QUEENSBOROUGH	K W IY N Z B ER OW
RURALLITY	R UH R AH L AH T IY
MOLON	M AA L AH N
SEABIRDS	S IY B ER D Z
CARAMBAR	K AH R AE M B AH R
CUMULONIMBUS	K Y UW M Y UW L AH N IH M B AH S
REINDEERS	R IY IH N D IH ER Z
LEGEND'S	L EH JH AH N D Z
SOAN	S OW AH N
PL	P IY L
SLADEN	S L EY D AH N
REPROOF	R IY P R UW F
AHKOND	AE K AH N D
KEEPETH	K IY P IH TH
DEPILATED	D IY P AY L EY T IH D
MEEKNESS	M IY K N AH S
EDITIO	AH D IH T IY OW
CLOTHO	K L AA TH OW
BITTERN'S	B AY T AH R N Z
LAMPLIT	L AE M P L IH T
CHALLAH	CH AE L AH
SLEETY	S L IY T IY
BINDWEED	B AY N D W IY D
PREENS	P R IY N Z
GOGGLEKY	G AA G L AH K IY
ELEPHENOR	AH L EH F AH N AH R
ENGLOBING	EH N G L OW B IH NG
COPSES	K AA P S IH Z
DOWERED	D AW ER D
REMOUILLENT	R AH M AW IH L AH N T
ARMLESS	AA R M L AH S
EV'N	EH V N
JONAHS	JH AA N AH Z
OWL'S	AW L Z
REDDENED	R EH D AH N D
L'ORNEMENT	L AO R N M AH N T
PEWIT	P Y UW AH T
MARK'D	M AA R K D
SWEETNESSES	S W IY T N AH S IH Z
RIDETH	R AY D IH TH
SMACKDAB	S M AE K D AE B
THORBERG	TH AO R B AH R G
UPSALL	AH P S AO L
DUDOON	D Y UW D UW N
TURNROW	T ER N R OW
CHAPEAU	CH EY P IY UW
LABOURERS	L EY B ER ER Z
CONVULSE	K AH N V AH L S
CLANGED	K L AE NG D
ASHBY'S	AE SH B IY Z
METHUSELAHS	M AH TH UW S AH L AH Z
HEREOF	HH IY R IY AH F
FLAVOURED	F L AH V OW Y AH R D
CALL'D	K AO L D
HOHENECK	HH AA HH AH N AH K
UNTYING	AH N T AY IH NG
SULPHURY	S AH L F ER IY
REEKIT	R IY EH K AH T
BUDDAH'S	B AH D AH Z
SLAKE	S L EY K
DIDNT	D IH D N T
PRONOUNC'T	P R OW N AW NG K T
PONYTAILS	P OW N IY T EY L Z
UNSHAVED	AH N SH EY V D
SQUATTED	S K W AA T IH D
HESPERUS	HH EH S AH R AH S
BEACHCOMBING	B IY CH K OW M IH NG
UNREVEALING	AH N R IH V IY L IH NG
TIGRESS	T AY G R AH S
KURROGLOU	K AH R AA G L UW
BLINDWORM	B L AY N D W ER M
UNLEARNING	AH N L ER N IH NG
FIRELOCKS	F AY ER L AA K S
CAULIFLOWERS	K AO L IH F L AW ER Z
TOKYOITES	T AA K AY OY T S
EFNE	EH F N
CONFUS'D	K AA N F AH S D
RINGTONES	R IH NG T OW N Z
SCUPTUR'D	S K AH P T AH R D
BABE'S	B EY B Z
CAMELLIAS	K AH M IY L Y AH Z
PEDLAR	P EH D L AH R
PEBBLED	P EH B AH L D
DESIR'D	D IY S ER D
KNEELS	N IY L Z
RICING	R AY S IH NG
DEVOUTNESS	D IH V AW T N AH S
PONGA	P AA N G AH
ASO	AE S OW
MEPHISTOPHELES	M AH F IH S T AH F IY L Z
SHRIMPING	SH R IH M P IH NG
HEMPHREY	HH EH M F R IY
CANKERED	K AE NG K ER D
CEPHEUS	S EH F IY AH S
LAMENTATIONS	L AE M AH N T EY SH AH N Z
CURTAIN'D	K ER T AH N D
ALBA'S	AE L B AH Z
TRAINYARD	T R EY N Y AA R D
SPARS	S P AA R Z
SLIPSTREAM	S L IH P S T R IY M
CITYSCAPE	S IH T IY S K EY P
CLOTHESLINE	K L OW DH Z L AY N
RUB'S	R AH B Z
APRONED	EY P R AH N D
HAPLY	HH AE P L IY
LIGHTNING'S	L AY T N IH NG Z
CAPERING	K EY P ER IH NG
PIGNA	P IH G N AH
PORTICOES	P OW R T IH K OW Z
RUSTUM'S	R AH S T AH M Z
MYTILENE	M IH T AH L IY N
REEDLESS	R IY D L AH S
SILBURY	S IH L B Y AH R IY
LANCES	L AE N S IH Z
DRAGGLING	D R AE G AH L IH NG
BEGING	B EH G IH NG
WOOER	W UW ER
RACCOON'S	R AE K UW N Z
BUDDLEIA	B AH D L IY AH
CADENCED	K EY D AH N S T
TOAD'S	T OW D Z
FUNERAL'S	F Y UW N ER AH L Z
WIPEOUTS	W AY P AW T S
SNOWDROPS	S N OW D R AA P S
PRANAYAMA	P R AH N EY AH M AH
FULLTHROATED	F UH L TH R OW T IH D
SHALLOWS	SH AE L OW Z
SWORD'S	S AO R D Z
POETRY'S	P OW AH T R IY Z
WHAPPING	W AA P AH NG
GLO'STER	G L AA S T AH R
PERFECTS	P ER F AH K T S
UNESPI'D	AH N EH S AH D
ASPIRINE	AE S AH R AY N
RESIFTED	R IY S IH F T IH D
SCHJELDAHL'S	S K JH EH L D AH L Z
SAITH	S EY TH
BULWARKED	B UH L W ER K T
SCRUM	S K R AH M
DIFFIDENT	D IH F AH D AH N T
TUMBLEWEEDS	T AH M B AH L W IY D Z
TWERE	T W IH R
GYROMANTIC	JH AY R OW M AE N T IH K
DÉCOLLETAGE	D EY K AA L AH T AH JH
BLACKSILK	B L AE K S IH L K
PUSSYWILLOW	P UH S IY W IH L OW
LABOURS	L EY B ER Z
FAWNS	F AO N Z
SERVITORS	S ER V AH T ER Z
PAU	P AO
LILTING	L IH L T IH NG
MUDJEKEEWIS	M AH JH AH K IY W AH S
KIRKSTONE	K AH R K S T OW N
JARL	JH AA R L
DEATHLIKE	D EH TH L AY K
REVOLTRESS	R AH V OW L T R AH S
PLAQUEMINE	P L AE K M AY N
HALOES	HH EY L OW Z
COTTONFIELDS	K AA T AH N F IY L D Z
WAKEN'D	W EY K AH N D
GECORONE	JH EH K AH R OW N
HANGMAN'S	HH AE NG M AH N Z
SOUL'S	S OW L Z
SLUICED	S L UW S T
YETI'S	Y EH T IY Z
THUDDING	TH AH D IH NG
CREWELWORK	K R UW AH L W ER K
DONKEY'S	D AA NG K IY Z
TAILGATING	T EY L G EY T IH NG
FRIGIL	F R IH JH AH L
PERADVENTURE	P ER AH D V EH N CH ER
EYESAT	AY S AE T
COMBINERS	K AH M B AY N ER Z
SYNGE	S IH N JH
POSTMEN	P OW S T M EH N
SADDLEBACK	S AE D AH L B AE K
ANYOLDHOW	AE N AY OW L D HH OW
FAMISH	F EY M IH SH
MONGRELS	M AA N G R AH L Z
CRUDER	K R UW D ER
UNDESIROUS	AH N D IH Z AY ER AH S
RAINBOWED	R EY N B AW D
PATTERNING	P AE T ER N IH NG
PINKED	P IH NG K T
ARTIC	AA R T IH K
UNCOGNISANT	AH N K AA G N AH S AH N T
FORENAME	F OW R N EY M
PREJUDICE'S	P R EH JH AH D IH S IX Z
WINDIER	W IH N D IY ER
BLACKWARD	B L AE K W ER D
SIRRAH	S AH R AH
PROPERTIUS	P R OW P AH R T AY AH S
QUENCHLESS	K W EH N CH L AH S
BEWINGED	B IH W IH NG D
ETNA'S	EH T N AH Z
GALLIOT	G AE L IY AH T
TUNICS	T UW N IH K S
RUFFIAN	R AH F IY AH N
FROLICS	F R AA L IH K S
RIALTO	R AY AE L T OW
FLORINS	F L AO R AH N Z
ENWOVEN	EH N W OW V AH N
VASTER	V AE S T ER
NACREOUS	N AE K R IY AH S
MATESHIP	M EY T SH IH P
ENCOUCH	EH N K AW CH
SPEEDEST	S P IY D AH S T
HIGHROAD	HH AY R OW D
BELOV'D	B AH L AA V D
PLEACHED	P L IY CH T
APPAL	AE P AH L
AMETHYSTS	AE M AH TH AH S T S
FÄ“NG	EH F EH N G
BIRDNOTE	B ER D N OW T
SAVOURY	S AH V AW R IY
FROUDE	F R AW D
KENTISH	K EH N T AH SH
YÃ¼N	Y N
UNRECAPTURED	AH N R IY K AE P CH ER D
AMEN'D	AH M EH N D
BLAZON	B L EY Z AH N
CELESTRIAL	S AH L EH S T R IY AH L
BASTILE	B AE S T AH L
WAISTCOAT	W EY S T K OW T
LETHEAN	L EH DH IY AH N
SUTLERS	S AH T L AH R Z
DULLY	D AH L IY
ENLARGENING	EH N L AA R JH AH N IH NG
DIMPLING	D IH M P L AH NG
BROADBOTTOMED	B R AO D B AA T AH M D
DAGUERREOTYPES	D AE G W EH R IY AH T AY P S
BRIARY	B R AY ER IY
BEFLOWERED	B IH F L AW ER D
FEARFULLY	F IH ER F AH L IY
GROOTVER'S	G R UW T V AH R Z
ABIT	AH B IH T
UNCONTROL	AH N K AH N T R OW L
SHOTTED	SH AA T IH D
DINS	D IH N Z
TAU	T AW
ANTOFAGASTAS	AE N T AH F AH G AE S T AH Z
GEMMED	JH EH M D
TOOKS	T UH K S
JEMENFOUTISTE	JH AH M EH N F AW T AY S T
Ã©TAIT	T EY T
UNQUIET	AH N K W AY AH T
SCAMANDER	S K AH M AE N D AH R
GREYS	G R EY Z
COUNTERSIGN	K AW N T ER S AY N
CHIEH	CH AY
CIRCLINGS	S ER K AH L IH NG Z
WOUNDFUL	W UW N D F AH L
O'ERHUNG	AA AH R AH NG
AMOR'S	AE M ER Z
SERAPHIC	S EH R AH F AH K
PRETTINESS	P R IH T IY N AH S
GREATENS	G R EY T AH N Z
FRESCA	F R EH S AH
GLAMOURS	G L AE M ER Z
INCARNADINING	IH N K AA R N AH D AY N AH NG
VERONA'S	V ER OW N AH Z
CONSTANTINE'S	K AA N S T AH N T IY N Z
ARBORS	AA R B ER Z
EV'RYTHING	EH V R AH DH AH NG
PATTERS	P AE T ER Z
FORMLESS	F AO R M L AH S
CLARET	K L AE R AH T
COACHMAN'S	K OW CH M AH N Z
PROPAGATES	P R AA P AH G EY T S
J'AVAIS	JH AE V EY AH S
MALINGERS	M AH L IH NG G ER Z
SUNDERING	S AH N D ER IH NG
BRUTES	B R UW T S
DRAPINGS	D R EY P IH NG Z
MANOEUVERING	M AH N OW AH AH V IY R AH NG
NECESSITOUS	N IH S EH S AH T AH S
COOTIE	K UW T AY
AZURES	AE Z Y AH R Z
CORNETS	K AA R N EH T S
ENDYMION	IH N D AY M IY AH N
BESEECHES	B IH S IY CH IH Z
RANKEST	R AE NG K AH S T
UNSTILTED	AH N S T IH L T IH D
PALER	P EY L ER
SOLACED	S AA L AH S T
REFRACTING	R IH F R AE K T IH NG
LIEST	L AY AH S T
OUTWORN	AW T W OW R N
UNCEASINGLY	AH N S IY S IH NG L IY
MIASMAL	M AY AE Z M AH L
UNDULANT	AH N JH AH L AH N T
GELDING'S	G EH L D IH NG Z
CLANGS	K L AE NG Z
THRALL'S	TH R AO L Z
FOILERS	F OY L ER Z
CANDOUR	K AE N D ER
JUTTED	JH AH T IH D
CHATOUILLAIS	CH AE T AW IH L EY AH S
MOTTOES	M AA T OW Z
KINDLINESS	K AY N D L IY N AH S
SLINGSBY	S L IH NG Z B AY
FASTNESSES	F AE S T N AH S IH Z
STRIPT	S T R IH P T
FITLY	F IH T L IY
IDEAN	AY D IY AH N
LERNA	L AH R N AH
FELON'S	F EH L AH N Z
TRADESMAN	T R EY D Z M AE N
MONSTERING	M AA N S T ER IH NG
Ã¦THER	TH EH R
TARLETON'S	T AA R L T AH N Z
VASSALAGE	V AE S AH L IH JH
HARBOURING	HH AA R B OW Y AH R AH NG
AFLUSH	AH F L AH SH
CHÄ“NG	S IY EY CH EH N G
RAGINGS	R EY JH IH NG Z
LAMPLESS	L AE M P L AH S
SMOULDERINGS	S M OW L D AH R AH NG Z
TOPAZES	T AH P EY Z AH Z
BARONY	B AE R AH N IY
CLAMOROUS	K L AE M ER AH S
PRETTILY	P R IH T IY L IY
BLASPHEME	B L AE S F IY M
SCATTERITH	S K AE T ER IY TH
GLINTED	G L IH N T IH D
LIE'S	L AY Z
WHEATHER	W IY DH AH R
SANDALLED	S AE N D AH L D
UNCORSETED	AH N K AH R S IY T AH D
GAPED	G EY P T
FLECKED	F L EH K T
UNCONFESSED	AH N K AH N F EH S T
ANNAM	AE N AH M
GUFFAWED	G AH F AO D
UNMEMORIED	AH N M EH M AH R IY D
BORGHESE	B AH R IY Z
TRACERIES	T R EY S AH R IY Z
AGONY'S	AE G AH N IY Z
BEAUTIFULNESS	B Y UW T IY F AH L N AH S
BEAMY	B IY M IY
QUACKED	K W AE K T
AEROPLANING	EH R AH P L EY N AH NG
UNSEPARATED	AH N S EH P ER EY T IH D
WHIRLS	W ER L Z
PREFECTS	P R IY F EH K T S
UNPEOPLED	AH N P IY P AH L D
LEVÃ©E	L IY V
UPREAR	AH P R IH ER
LORDLIEST	L AO R D L IY AH S T
UNANSWERING	AH N AE N S ER IH NG
AWAKENINGS	AH W EY K AH N IH NG Z
MULLEIN	M UH L IY N
WAT'RY	W AA T R IY
TRILLIUM	T R IH L IY AH M
GRAVED	G R EY V D
LUSTIHOOD	L AH S T IY HH UH D
RINGLETS	R IH NG L AH T S
CHIFFONIER	CH IH F AA N AY AH R
Ã
KNEE'S	N IY Z
MENCIUS	M EH N S AY AH S
STAMINATE	S T EY M AH N AH T
SLOUGHED	S L AH F T
PRODIGALITY	P R AA D IH G AH L AH T IY
IMPOVERISHINGS	IH M P AA V R IH SH IH NG Z
BEGUILES	B IH G AY L Z
DREAMEST	D R IY M AH S T
NOSTALGICALLY	N AH S T AE L JH IH K AH L IY
UNSTUMBLING	AH N S T AH M B AH L IH NG
LEGIONING	L IY JH AH N IH NG
TROCHEE	T R AH CH IY IY
BERTHE	B IH R DH IY
CLAPPERS	K L AE P ER Z
JACKSTONES	JH AE K S T OW N Z
APPARELLED	AH P AE R AH L D
PHÅ“NIX	F N IH K S
FRAILER	F R EY L ER
VACUITY	V AE K Y UW AH T IY
ARDOUR	AA R D AH R
JOYOUSNESS	JH OY AH S N AH S
HAIRPINS	HH EH R P IH N Z
STEAM'S	S T IY M Z
HSÃ¼	EY CH EH S
CUPOLAS	K Y UW P AH L AH Z
PAGEANTING	P AE JH AH N T IH NG
AFLARE	AH F L EH R
STEEPLED	S T IY P AH L D
UNCONSIDERINGLY	AH N K AH N S IH D ER IH NG L IY
PHAETON	F IY T AH N
FLEA'D	F L IY D
VALOR'S	V AE L ER Z
RIPENS	R AY P AH N Z
JACKET'S	JH AE K AH TS
POCKHOLED	P AA K OW L D
GRISHKIN	G R IH SH AH N
WATCHEST	W AA CH AH S T
RESCRIPTS	R IY S K R IH P T S
LISPS	L IH S P S
VOLUPINE	V AA L AH P AY N
SUNDERED	S AH N D ER D
GULLED	G AH L D
FAFAIA	F AE F EY AH
INTERPOSED	IH N T ER P OW Z D
SLUMBROUS	S L AH M B R AH S
EXTERNALS	EH K S T ER N AH L Z
MASQUERADES	M AE S K ER EY D Z
HEDGEROWS	HH EH JH R OW Z
BOCKS	B AA K S
TONELESS	T OW N L AH S
QUIVERED	K W IH V ER D
LIPLESS	L IH P L AH S
BAILHACHE	B EY L HH AH CH
ANCHISES	AE NG K AY Z AH Z
SLUMBER'S	S L AH M B ER Z
TÄ“NG	T IY EH N G
JANGLES	JH AE NG G AH L Z
FAMISHES	F EY M IH SH IH Z
LUSTRELESS	L AH S T ER L AH S
DISSOLUTE	D IH S AA L Y UW T
AUBADE	AH B EY D
ANFRACTUOUS	AE N F R AE K T Y AH W AH S
DRAGGLED	D R AE G AH L D
DEFUNCTIVE	D IH F AH NG K T IH V
THEEWARD	TH IY W AH R D
FOETOR	F OW AH T AH R
COMPANIONED	K AH M P AE N Y AH N D
SHRIVEN	SH R AY V AH N
TOMBED	T UW M D
SCOWLS	S K AW L Z
HAVETH	HH EY V AH TH
O'ERTAXED	AH AH R T AH K S T
THOUGHTLESSLY	TH AO T L AH S L IY
CAMMEL	K AE M AH L
DELF	D EH L F
BUDDED	B AH D IH D
BAMBOOS	B AE M B UW Z
SLAKING	S L EY K IH NG
PUNGENCE	P AH N JH AH N S
SCATHLESS	S K AE TH L AH S
REQUITE	R IH K W AY T
OSTERIAS	AA S T IY R IY AH Z
AGLOOM	AH G L UW M
PURPLY	P ER P AH L IY
TRYSTS	T R IH S T S
SKYEY	S K AY IY
BOUNTEOUS	B AW N T IY AH S
AURONT	AO R AH N T
NIGHER	N AY ER
GILLYFLOWERS	G IH L IY F L AW ER Z
PROMPTINGS	P R AA M P T IH NG Z
CAN'ST	K AE N S T
CHALICES	CH AE L AH S
HARPIES	HH AA R P IY Z
UNWORDED	AH N W ER D IH D
DEAFER	D EH F ER
AVENTINE	AE V AH N T AY N
KNOWING'S	N OW IH NG Z
OTHERWHENCE	AH TH AH R W AH N S
GREASIER	G R IY S IY ER
SUBLIMING	S AH B L AY M IH NG
COQUETTE	K OW K EH T
POLYPHILOPROGENITIVE	P AH L IH F AH L AA P R AH JH EH N AH T AH V
VELLEITIES	V EH L AH T AY Z
COMPASSING	K AH M P AH S IH NG
SOLDIERY	S OW L JH AH R IY
BELLYFUL	B EH L IY F AH L
LINGERINGLY	L IH NG G ER IH NG L IY
FROTHING	F R AO TH IH NG
PHLACCUS	F L AE K AH S
UNGRIEVING	AH N G R IY V IH NG
PROMETHEAN	P R OW M EH DH IY AH N
CONNUBIAL	K AA N Y UW B IY AH L
TRIUMPHING	T R AY AH M F IH NG
ADAMANTINE	AH D AE M AH N T AY N
BABRAHAM	B AE B R AH HH AH M
ENTHRALLS	IH N TH R AE L Z
UNHASPED	AH N HH AE S P T
JUVESCENCE	JH UW V EH S AH N S
BRACELETED	B R EY S L AH T IH D
PUISSANCE	P Y UW AH S AH N S
ELISHA'S	EH L IH SH AH Z
BOULDERED	B OW L D ER D
LUSTRES	L AH S T ER Z
CASQUE	K AE S
NOON'S	N UW N Z
ALMANDINE	AE L M AH N D AY N
SHRILLY	SH R IH L IY
HESPERIAN	HH EH S IY R IY AH N
VEERY	V IH ER IY
UNAPPEASABLE	AH N AH P IY Z AH B AH L
DEVOTIONS	D IH V OW SH AH N Z
GLENCOE'S	G L EH NG K OW AH Z
BEACONED	B IY K AH N D
TREED	T R IY D
BOOKROOM	B UH K R UW M
XENIUS	Z EH N AY AH S
PRIAPUS	P R AY AH P AH S
CLOUDLAND	K L AW D L AE N D
PAVEN	P EY V AH N
AEONS	IY AA N Z
DAWNLIT	D AO N L IH T
PRENATALLY	P R IY N EY T AH L IY
COLUMN'S	K AA L AH M Z
TYRANNISE	T IH R AH N AY Z
REPRIEVES	R IH P R IY V Z
GLUTTON	G L AH T AH N
MULBERRIES	M UH L B EH R AY Z
UPRISES	AH P R IY Z IH Z
CAESURA	K IY S AH R AH
GATINEAU	G AH T IH N IY UW
SCAMP	S K AE M P
NIPOTINA	N AH P AA T AH N AH
QUIETUDE	K W AY AH T UW D
J'Ã©PROUVAIS	JH P R AW V EY AH S
MURMUROUS	M ER M ER AH S
CARVEN	K AA R V AH N
SPECTRED	S P EH K T ER D
UNDISCERNING	AH N D IH S ER N IH NG
ALORS	EY L ER Z
SPELT	S P EH L T
FRUCTIFYING	F R AH K T IH F AY AH NG
FALCONIER	F AE L K AH N IY ER
DREAMLESS	D R IY M L AH S
GYVE	JH AY V
A'GAINST	AE G EY N S T
DEMOSTHENES	D AH M AA S TH IY N Z
COLOUR'S	K AH L ER Z
PISTILATE	P AY Z T AY L AH T
CONSCIENCE'S	K AA N SH AH N S IX Z
SEPTTANS	S EH P T AH N Z
TRAVERSÃ©	T R AE V AH R Z
UPSPRINGING	AH P S P R IH NG IH NG
AZURE'S	AE ZH ER Z
CHAFFED	CH AE F T
POURBOIRES	P AH R B OY R Z
DRAGOONS	D R AH G UW N Z
FLAMINA	F L AE M AH N AH
SLEEPSIN	S L IY P S IH N
EVOCATIVELY	IH V AA K AH T IH V L IY
ANADYOMENE	AH N AE D AY AH M IY N
WENDOVER	W EH N D OW V AH R
ATELIERS	EY T L IY ER Z
BERYLS	B EH R AH L Z
YÃ¼	Y
OATEN	OW T AH N
HONEYCOMBED	HH AH N IY K OW M D
GIRTHS	G ER TH S
YÃ¼AN	Y AE N
IRRESTRAINT	IH R IH S T R EY N T
RILLET	R IH L AH T
HSÃ¼N	EY CH EH S N
UNROOFED	AH N R UW F T
JOSTLES	JH AA S AH L Z
STERNE'S	S T ER N Z
GOBLETS	G AA B L AH T S
ARIADNE'S	EH R IY AE D N IY Z
UNFALLING	AH N F AO L IH NG
SEETHED	S IY TH T
BASILISKS	B AE S AH L AH S
AMBULATION	AE M B Y AH L EY SH AH N
HASLINGFIELD	HH AA Z L IH NG F IY L D
RAPTURE'S	R AE P CH ER Z
PEDDLER'S	P EH D L ER Z
INCARNADINE	IH N K AA R N AH D AY N
STROWN	S T R OW N
PESTILENCES	P EH S T AH L AH N S IH Z
REMOUNT	R IY M AW N T
FILCHING	F IH L CH IH NG
TAPPINGS	T AE P IH NG Z
ETERNITIES	IH T ER N AH T IY Z
IMPOTENTLY	IH M P AH T AH N T L IY
STUPEFY	S T UW P AH F AY
DÃ©LIRE	D L AY R
SIGNIFES	S IH G N AY F S
PURLED	P ER L D
GREATENING	G R EY T AH N IH NG
YÃ¼EH	Y IY
CHALICED	CH AE L AH S T
CAUCHEMAR	K AO K AH M AH R
BODINGS	B OW D IH NG Z
UNRETURNING	AH N R IY T ER N IH NG
BRASSIEST	B R AE S IY AH S T
COUNTERPANE	K AW N T ER P EY N
UNMAILED	AH N M EY L D
MIGHTST	M AY T S T
PILLOWED	P IH L OW D
PAULOVNIA	P AH L AA V N IY AH
UNDIMMED	AH N D IH M D
FLAME'S	F L EY M Z
BELLYING	B EH L IY IH NG
UNEAGER	AH N IY G ER
TOADSTOOL	T OW D S T UW L
ILLUMINES	IH L UW M AH N Z
UNPROFAINED	AH N P R AH F EY N D
WHISPERINGLY	W IH S P ER IH NG L IY
UNSHOD	AH N SH AA D
RIRE	R AY R
CLARETS	K L AE R AH T S
ANNOINTED	AE N OY N T AH D
GRENADIER	G R AH N EY D IY ER
THIRST'S	TH ER S TS
CHAWED	CH AO D
BOSOM'S	B UH Z AH M Z
TROY'S	T R OY Z
FIRCRESTED	F ER K R EH S T IH D
PUPURE	P AH P Y ER
BEHELDEST	B IH HH EH L D AH S T
UNNOTICING	AH N OW T AH S IH NG
WISTARIA	W IH S T AE R IY AH
PROTEUS	P R OW T IY AH S
PARCÃ¦	P AA R K
KURLER'S	K AH R L AH R Z
STIGMATED	S T IH G M AH T EH D
HALLOWÃ©D	HH AE L OW D
LEISURED	L EH ZH ER D
CONVEXING	K AA N V EH K S IH NG
KEENNESS	K IY N AH S
IMPEARLED	IH M P ER L D
WHITEING	W AY T IH NG
GAFFED	G AE F T
UNBRAIDED	AH N B R EY D IH D
SAGACIOUSLY	S EY JH AH S IY AH S L IY
CENTURIED	S EH N CH AH R IY D
JANNES	JH AE N Z
NEIGHING	N EY AH NG
UNRESTS	AH N R EH S T S
EITHER'S	IY DH ER Z
VOTARY	V OW T EH R IY
BUILDED	B IH L D IH D
GLENCOE	G L EH NG K OW
CONCITATION	K AH N S AY T EY SH AH N
CRUMPETS	K R AH M P AH T S
UNCHASTE	AH N CH EY S T
GULFED	G AH L F T
UNNUMBERED	AH N AH M B ER D
COVERLET	K OW V EH R L AH T
HUAI	HH Y UW EY
CONVOLUTIONS	K AA N V AH L UW SH AH N Z
THEREUNDER	DH AE R AH N D ER
LOFTNESS	L AO F T N AH S
YEASTING	Y IY S T IH NG
LOATHES	L OW TH S
LIBATIONS	L AH B EY T IY AH N Z
INCURIOUS	IH N K Y UH R IY AH S
ANOINTS	AH N OY N T S
BLASPHEMING	B L AE S F IY M IH NG
HIPPO'S	HH IH P OW Z
BRIMS	B R IH M Z
ECHOLESS	EH K OW L AH S
ULTRAMUNDANES	AH L T R AH M AH N D EY N Z
UNCOMFORTED	AH N K AH M F ER T IH D
BURN'S	B ER N Z
FRATRICIDAL	F R AE T R IH S AH D AH L
JUFVROUW	JH AH F V R AW W
OVERBALANCED	OW V ER B AE L AH N S T
EVENFALL	IY V AH N F AO L
NERVELESS	N ER V L AH S
BASKETFUL	B AE S K AH T F AH L
MARVELEST	M AA R V AH L AH S T
COUPLETS	K UW L AH T S
PAIN'S	P EY N Z
GARMENT'S	G AA R M AH N TS
METAMORPHOSES	M EH T AH M AO R F OW Z IH Z
NOISELESSLY	N OY Z L AH S L IY
PUNCTUALLY	P AH NG K CH AH W AH L IY
GIBBET	JH IH B AH T
ARROVE	AE R OW V
TELEOLOGICALLY	T EH L IY AH L AA JH IH K AH L IY
UNSPOTTED	AH N S P AA T IH D
TRALLIANOS	T R AE L IY AH N AH Z
DUMFOUNDED	D AH M F AW N D AH D
RETCHINGS	R EH CH IH NG Z
CHIAO	CH AY AH OW
ADEPTS	AE D EH P T S
HIDALGO'S	HH AH D AE L G OW Z
CONFUTE	K AH N F Y UW T
CH	S IY
SLIMIER	S L AY M IY ER
CRUMPLES	K R AH M P AH L Z
UNSHEATHED	AH N SH IY DH D
WREATHÃ©D	R IY TH D
WAYFARER	W EY F EH R ER
PLEASURE'S	P L EH ZH ER Z
WREACHES	R IY CH AH Z
CLAYMORES	K L EY M AO R EY Z
UNSOWN	AH N S OW N
ENTRAMMLED	IH N T R AE M AH L D
POPINA	P AA P AH N AH
EMPTILY	EH M P T IY L IY
STRANGLERS	S T R AE NG G AH L ER Z
SNUFFLE	S N AH F AH L
COGITATIONS	K OW JH AH T EY T IY AH N Z
TWILIGHT'S	T W AY L AY TS
HEAR'ST	HH IY R S T
SLITHERED	S L IH TH ER D
O'CLOCKS	AH K L AA K S
DANDIFIED	D AE N D AH F AY D
MADDENED	M AE D AH N D
LEGION'S	L IY JH AH N Z
MENIALS	M IY N IY AH L Z
IMPERISHABLE	IH M P EH R IH SH AH B AH L
CHIRRUPS	CH AH R AH P S
PARTAKING	P AA R T EY K IH NG
ENRAPTURING	EH N R AE P CH ER IH NG
RARIFY	R EH R AH F AY
SEPULTURED	S AH P UH L T Y AH R D
BEDAUBED	B IH D AO B D
COLIC	K OW L IH K
CICALAS	S IH K AH L AH Z
DAIMYO	D EY M AY OW
CLOTILDE'S	K L AH T IH L D AH Z
GULCHES	G AH L CH AH Z
ENAMOURED	AH N AH M OW Y AH R D
HEXAMETERS	HH EH K S AE M AH T ER Z
FLAMBEAU	F L AE M B IY UW
UNGUESSED	AH N G EH S T
GOLDER'S	G OW L D ER Z
JOVE'S	JH OW V AH Z
JUICINESS	JH UW S IY N AH S
FUDDLED	F AH D AH L D
CRETANS	K R EH T AH N Z
DREAMINGS	D R IY M IH NG Z
WRIGGLING	R IH G L AH NG
NECTARINE	N EH K T AH R AY N
DESPONDENCE	D IH S P AA N D AH N S
FULGENCE	F UH L JH AH N S
OFFICIOUS	AH F IH SH AH S
CYTHERA	S IH TH AH R AH
RADEGONDE	R AE D AH G AH N D
DEPREDATE	D EH P R AH D EY T
CIMERIAN	S AH M IY R IY AH N
NURSIE	N ER S IY
PERORATE	P ER AO R EY T
KURLER	K AH R L AH R
RELUMED	R AH L UW M D
INFAMY'S	IH N F AH M IY Z
WETTED	W EH T IH D
AUREOLED	AO R IY OW L D
SSÅ­	EH S EH S
FEWNESS	F Y UW N AH S
LUSTS	L AH S T S
HAWAIAN	HH AO EY IY AH N
TWITTERINGS	T W IH T ER IH NG Z
TEASHOPS	T IY SH AA P S
MADINGLEY	M AH D IH N G L IY
CHASUBLES	CH AE S AH B AH L Z
REGARDEST	R IH G AA R D AH S T
REPOSES	R IY P OW Z IH Z
PLODS	P L AA D Z
VOILÃ 	V OY L
THORPS	TH AO R P S
TROUTS	T R AW T S
APPLEBLOOMS	AE P AH L B L UW M Z
RESOUNDED	R IY S AW N D IH D
FINNY	F IH N IY
IDLERS	AY D AH L ER Z
TUMBLETH	T AH M B AH L IH TH
SPLENDENT	S P L EH N D AH N T
BRANCHÃ¨D	B R AE NG K D
SCYTHES	S IH DH Z
PALAZZOS	P AH L AE Z AH Z
CREESE	K R IY Z
FOULER	F AW L ER
ABJURE	AE B Y AH R
DOONG	D UW NG
REJOICEST	R IH JH OY S AH S T
SEDUCERS	S IH D UW S ER Z
DARKING	D AA R K IH NG
LEERING	L IH ER IH NG
BLEISTEIN'S	B L IY S T IY N Z
PENETRATIVE	P EH N AH T R AH T IH V
LIGHTENINGS	L AY T AH N IH NG Z
WHINS	W IH N Z
TROYWARD	T R OY W ER D
SAGGY	S AE G IY
RABBLE'S	R AE B AH L Z
CARFARE	K AA R F EH R
DANG'ROUS	D AE N G R AH S
MONSTROUSLY	M AA N S T R AH S L IY
IAMB	AY AH M
CRINKLED	K R IH NG K AH L D
COQUETTED	K OW K EH T IH D
UNBEAUTIFUL	AH N B Y UW T IY F AH L
UNOFFENDING	AH N AH F EH N D IH NG
LAPT	L AE P T
HORNÃ¨D	HH AO R N D
APOLLINAX	AH P OW L IH N AE K S
MAGNIFICENCE	M AE G N IH F AH S AH N S
UPROLLED	AH P R OW L D
UPBRAIDS	AH P B R EY D Z
MEMOREM	M EH M AH R AH M
OUTROLLED	AW T R OW L D
MOULDERING	M OW L D ER IH NG
SHAMEFULLY	SH EY M F AH L IY
TRENTALS	T R EH N T AH L Z
LAODICEANS	L EY AA D AH S IY N Z
ALCHEMIED	AE L K AH M IY D
CIRCUMFERENCES	S ER K AH M F R AH N S IH Z
KINDLIER	K AY N D L IY ER
HEEDFUL	HH IY D F AH L
LADYFRIENDS	L EY D IY F R EH N D Z
TARPEIA'S	T AA R P IY AH Z
UNWIST	AH N W AH S T
SUBDUER	S AH B D UW ER
DIAPERED	D AY P ER D
ASBINE	AE Z AY N
TRANSFUSING	T R AE N S F Y UW Z IH NG
MENELAUS	M AH N EH L EY AH S
PARACLETE	P AE R AH K L IY T
CHÃ¼	S IY EY CH
MANACLED	M AE N AH K AH L D
HIPPOPOTAMUS'S	HH IH P AH P AA T AH M AH S IX Z
FORSAKES	F AO R S EY K S
STRIATED	S T R AY EY T AH D
UNEXPRESSED	AH N IH K S P R EH S T
BURSTEN	B ER S T AH N
HAWKWEED	HH AO K W IY D
DIRGES	D ER JH IH Z
POTAMUS	P AA T AH M AH S
HESSIANS	HH EH SH AH N Z
CHINKING	CH IH NG K IH NG
BURGH	B AH R
ARABESQUED	AE R AH B EH S K T
DISCORDS	D IH S K AO R D Z
UNWORTHILY	AH N W ER DH IY L IY
FOETUS	F OW AH T AH S
UNCOMPREHENDING	AH N K AA M P R IH HH EH N D IH NG
UNFALTERING	AH N F AO L T ER IH NG
UNACADEMIC	AH N AE K AH D EH M IH K
PLEASANTEST	P L EH Z AH N T AH S T
MAZ'D	M AE Z D
EAGLING	IY G AH L IH NG
PULPY	P AH L P IY
IGNATII	IH G N AH T IY
SPARKLESS	S P AA R K L AH S
GARNETS	G AA R N AH T S
MISGIVES	M IH S G IH V Z
INVENTION'S	IH N V EH N SH AH N Z
STAY'D	S T EY D
DESPONDENTLY	D IH S P AA N D AH N T L IY
CURVETS	K ER V EH T S
FORNICATION	F AO R N AY S EY SH AH N
FULMINATES	F UH L M AH N EY T S
INTERLACES	IH N T ER L EY S IH Z
NAIAD'S	N EY AH D Z
INCORRUPTIBLE	IH N K AH R AH P T AH B AH L
FLEABANE	F L IY B EY N
COMRADELESS	K AA M R AE D L AH S
CARABINE	K AE R AH B AY N
FORGE'S	F AO R JH IX Z
FAERY	F AE ER IY
OBLATION	AA B L EY SH AH N
ARABESQUES	AE R AH B EH S K S
TRAVAILLED	T R AH V EY L D
HSIEN	HH S AY AH N
STONECROP	S T OW N K R AA P
FARTHINGS	F AA R TH IH NG Z
MEADOW'S	M EH D OW Z
QUEERLY	K W IH ER L IY
SEMBLANCES	S EH M B L AH N S IH Z
MURDER'S	M ER D ER Z
GURGLED	G ER G AH L D
CURTSEYS	K ER T S IY Z
THINKEST	TH IH NG K AH S T
ISN	IH Z N
HORROR'S	HH AO R ER Z
HILVERDINK	HH IH L V AH R D AH NG K
WALLABOUT	W AO L AH B AW T
AMBARVALIA	AE M B AH R V EY L Y AH
CHAFFERED	CH AE F ER D
DEFLOWERED	D IY F L AW ER D
IMPERMANENT	IH M P ER M AH N AH N T
GRANTCHESTER	G R AE N T CH EH S T ER
FAGGOTS	F AE G AH T S
BILAN	B AY L AH N
SWAGGERED	S W AE G ER D
LIST'NING	L IH S T N AH NG
UNBAPTIZED	AH N B AE P T IH Z D
VARLET	V AA R L AH T
CUCKOLD	K AH K OW L D
COULE	K OW UW L
CARION	K EH R IY AH N
OPES	OW P S
JESTING	JH EH S T IH NG
FRIENDED	F R EH N D IH D
WÄ“N	D AH B AH L Y UW N
IRRESOLUTE	IH R EH Z AH L UW T
QUAYS	K W EY Z
PURPOSELESSLY	P ER P AH S L AH S L IY
BULLETED	B UH L AH T IH D
HAUGHTINESS	HH AO T IY N AH S
FEEL'ST	F IY L S T
CLOUDRIFT	K L AW D R IH F T
QUERULOUSLY	K W EH R AH L AH S L IY
UNTAMABLE	AH N T EY M AH B AH L
MEWARD	M Y UW AH R D
STEALTHILY	S T EH L TH IY L IY
WIDENESS	W AY D N AH S
CLINKER	K L IH NG K ER
WATCHMAN'S	W AA CH M AH N Z
STILOW	S T IH L OW
FRORE	F R AO R
WESTERING	W EH S T ER IH NG
GODWARD	G AA D W ER D
BOREUS	B AO R IY AH S
UNREALMED	AH N R EH L M D
SHEERED	SH IH ER D
MAMUA	M AE M Y UW AH
TARPAULINS	T AA R P AH L AH N Z
EPOCH'S	EH P AH K S
JESTED	JH EH S T IH D
BROOCHES	B R UW CH AH Z
PROSODICAL	P R AH Z AA D IH K AH L
MARGUERITES	M AA R G Y UW AH R AY T S
MILTON'S	M IH L T AH N Z
UNHEWN	AH N HH Y UW N
FÄ“N	EH F N
VIRTUE'S	V ER CH UW Z
FORTUITOUSLY	F AO R T UW T OW AH S L IY
ORKUS	AO R K AH S
MUTELY	M Y UW T L IY
HANDMAIDS	HH AE N D M EY D Z
CASED	K EY S T
PRACTISING	P R AE K T AH S IH NG
YOSHIWARA	Y AH SH IH W AH R AH
PASSAGEWAYS	P AE S IH JH W EY Z
TOILERS	T OY L ER Z
UNWINKING	AH N W IH NG K IH NG
EERY	IY AH R IY
SACRAMENTED	S AE K R AH M AH N T IH D
HSIANG	HH S AY AH NG
CRYS	K R AY Z
CONSANGUINITY	K AA N S AE N G W IH N AH T IY
MULLEINS	M UH L IY N Z
SENTIMENTALIZES	S EH N T AH M EH N T AH L AY Z IH Z
YESTERNIGHT	Y EH S T AH R N AY T
FIEND'S	F IY N D Z
REPROACHES	R IH P R OW CH IH Z
INFLEXIONS	IH N F L EH K SH AH N Z
LOZENGED	L AA Z AH NG D
ILS	IH L Z
HOUSEMAIDS	HH AW S M EY D Z
TORRIES	T AO R IY Z
BLEAR	B L IH ER
LAURELED	L AO R AH L D
O'ERSTRAINED	OW ER Z T R EY N D
MATAIEA	M AH T EY IY AH
QUIRITES	K W AH R AY T S
HOSANNAS	HH AH S AE N AH Z
SHANG	SH AE NG
CHYME	CH AY M
BED'S	B EH D Z
AXLETREE	AE K S AH L T R IY
ANTONYS	AE N T AO N IY Z
TINCT	T IH NG K T
SUNRISING	S AH N R IY Z IH NG
TARRIES	T AE R IY Z
ORANG	AO R AH NG
FRUCTIFY	F R AH K T AH F AY
BLAZONED	B L EY Z AH N D
JUDA'S	JH UW D AH Z
ENTONE	EH N T OW N
DIVINED	D AH V AY N D
MACULATE	M AE K Y AH L EY T
EARDRUMS	IH ER D R AH M Z
HARLOTRY	HH AA R L AA T R IY
UNSCARRED	AH N S K AA R D
HSIN	HH S IH N
SHAMMED	SH AE M D
INENARRABLE	IH N AH N ER AH B AH L
TARRYING	T AE R IY IH NG
YOKING	Y OW K IH NG
ENAMELLED	IH N AE M AH L D
ENSHROUDING	EH N SH R AW D IH NG
BUSTLES	B AH S AH L Z
REDIGE	R AH D AY JH
HALO'S	HH EY L OW Z
HEADBOWED	HH EH D B AW D
AMUSEDLY	AH M Y UW Z AH D L IY
PASSIVENESS	P AE S IH V N AH S
PINACLES	P IH N AH K AH L Z
BLIGHTS	B L AY T S
WEALS	W IY L Z
CHIH	CH IY
PRISMED	P R IH Z M D
BROADCLOTH	B R AO D K L AO TH
RAPIERS	R EY P IY ER Z
MOND	M AA N D
ALCMENE	AE L K M IY N
OUTFLUNG	AW T F L AH NG
CLOTILDE	K L AA T AH L D
SAMPSON'S	S AE M P S AH N Z
UNBURDENS	AH N B ER D AH N Z
TEMPERAMENTVOLL	T EH M P AH R AH M EH N T V AH L
ABBESS	AE B AH S
SHERDS	SH AH R D Z
GROOTVER	G R UW T V AH R
GABIES	G AE B IY Z
SUPERNAL	S UW P AH R N AH L
DROUTH	D R AW TH
HURLES	HH AH R L Z
GLAZEN	G L EY Z AH N
POLYMATH	P OW L IY M AE TH
SHORELESSLY	SH OW R L AH S L IY
STILOW'S	S T AH L OW Z
SOARINGS	S OW R IH NG Z
MOULTED	M OW L T AH D
FLORUS	F L AO R AH S
VAINS	V EY N Z
UMBRIAN	AH M B R IY AH N
YAI	Y EY
COBBLES	K AA B AH L Z
BLADE'S	B L EY D Z
CHÄ“N	S IY EY CH N
SUPERINTENDENCE	S UW P ER IH N T EH N D AH N S
THUND'RED	TH AH N D R D
WANTONNESS	W AO N T AH N AH S
ABLOWING	AH B L OW IH NG
OFFICIOUSNESS	AH F IH SH AH S N AH S
WRECKERS	R EH K ER Z
ZUIDER	Z UW D AH R
OVERSCORED	OW V ER S K OW R D
UNHOPED	AH N HH OW P T
SHAGREEN	SH EY G R IY AH N
HESPERIDES	HH EH S AH R AY D Z
NAIADS	N EY AH D Z
BEATITUDE	B IY AE T AH T UW D
CLASPING	K L AE S P IH NG
UNEMBROIDERED	AH N IH M B R OY D ER D
CRIMSONED	K R IH M Z AH N D
BOUDOIRS	B UW D W AA Z
TRING	T R IH NG
THROE	TH R OW
SCALY	S K EY L IY
BALUSTRADE	B AE L AH S T R EY D
CLAMOURING	K L AH M OW Y AH R AH NG
TANKARDS	T AE NG K AH R D Z
FRUMPS	F R AH M P S
SNOWDROP	S N OW D R AA P
AWHIRL	AH W ER L
ILEX	IH L AH K S
FAÃ§ADES	F AA D Z
CRANNIED	K R AE N IY D
JAPANEE	JH AH P AE N IY
IMPROVIDENT	IH M P R AH V AY D AH N T
WEFTS	W EH F T S
TCHIREK	CH IH R AH K
AERATED	AE ER EY T IH D
WHISPERINGS	W IH S P ER IH NG Z
REPINE	R IY P AY N
FONTANI	F AA N T AH N IY
LINGAM	L IH N G AH M
HIGHTENING	HH AY T EH N IH NG
ISTRIA	IH S T R IY AH
DESPONDINGLY	D IH S P AA N D IH NG L IY
PORTICOS	P OW R T IH K OW Z
OBLIVION'S	AH B L IH V IY AH N Z
CALLISTO	K AE L IH S T OW
VAUTOUR	V AO T AH R
CLAMOURED	K L AH M OW Y AH R D
COCKLESHELL	K AA K L EH SH AH L
MUD'S	M AH D Z
BREASTLESS	B R EH S T L AH S
UNENDURABLE	AH N EH N D UH R AH B AH L
REFASHIONED	R IY F AE SH AH N D
NIOBE	N AY OW B
PROFFERS	P R AA F ER Z
MARVELLOUSLY	M AA R V AH L AH S L IY
UNCONCEIVED	AH N K AH N S IY V D
THRALDOM'S	TH R AE L D AH M Z
NURSEMAID	N ER S M EY D
TANED	T AE N D
BENISONS	B IY AH N IY Z AO N Z
BOOTLESS	B UW T L AH S
EPICENE	EH P AH S IY N
BYDAM	B AY D AE M
BREUCK	B R UW K
DAUNTS	D AO N T S
DESCANT	D IY S K AE N T
ETERNALING	IH T ER N AH L IH NG
TAMISEL	T AE M AH S AH L
STARFIRE	S T AA R F AY ER
SWIMMETH	S W IH M IH TH
KIPLING'S	K IH P L IH NG Z
SUMACHS	S UW M AH CH S
BEDAZZLES	B IH D AE Z AH L Z
ENTWINING	EH N T W AY N IH NG
BALUSTERS	B AH L AH S T AH R Z
ECLYPSE	EH K L AH P S
APENECK	EY P N EH K
ENSIGNS	EH N S AH N Z
UNCLASPED	AH N K L AE S P T
STEPT	S T EH P T
CHANTY	CH AE N T IY
MAKAWELI	M AH K AO AH L IY
UNSUNN'D	AH N S AH N D
WINDPIPE	W IH N D P AY P
DAMASKED	D AE M AE S K T
CHIPPINGS	CH IH P IH NG Z
SOMEWHILE	S AA M Y UW AH L
INEBRIATION	AH N EH B R AY EY SH AH N
OVERBORNE	OW V ER B AO R N
TINGING	T IH NG AH NG
GNARLÃ¨D	N AA R L D
PRESTER	P R EH S T AH R
FAMES	F EY M Z
MYNHEER	M AH N EH R
COMPLINE	K AA M P L AY N
GRANDEURS	G R AE N JH ER Z
THRALDOM	TH R AE L
GOBBETS	G AA B EH T S
OSIERED	AA S IY ER D
CITYWARD	S IH T IY W ER D
GREWETH	G R UW IH TH
AZURED	AE Z Y AH R D
DUMBLY	D AH M L IY
SATURNINE	S AE T AH R N AY N
LADDER'S	L AE D ER Z
VIGOUR	V IH G AH R
HEXAMETER'S	HH EH K S AE M AH T ER Z
BESTUD	B IH S T AH D
COMFORT'S	K AH M F ER TS
TROYS	T R OY Z
WEATHERCOCK	W EH DH ER K AA K
PRIVATEER	P R AY V AH T IH R
SAVOURLESS	S AE V AH Y UH R L AH S
MACAROON	M AE K AH R UW N
UNASSAILED	AH N AH S EY L D
CAINS	K EY N Z
GRUDGED	G R AH JH D
CREEPERS	K R IY P ER Z
TRILLIUMS	T R IH L IY AH M Z
MÄ“NG	EH M EH N G
ELEUSIS	IY L UW S AH S
PRISMING	P R IH Z M AH NG
TRANSFIGURING	T R AE N S F IH G Y ER IH NG
MARTYR'D	M AA R T ER D
SHAME'S	SH EY M Z
BRAGGART	B R AE G AH R T
VULTURED	V AH L CH ER D
TZÅ­	T IY Z IY
TRUENESS	T R UW N AH S
DOUX	D AW K S
PALLIDLY	P AE L AH D L IY
SORROWING	S AA R OW IH NG
DEGRADATION'S	D EH G R AH D EY SH AH N Z
UNBREATHING	AH N B R IY DH IH NG
TRANSEPTS	T R AE N S EH P T S
BALHAM	B IY AH L HH AE M
UNCARED	AH N K EH R D
JACINTHS	JH AE S AH N TH S
COUNCILLOR	K AW N S AH L ER
POTENCIES	P OW T AH N S IY Z
PASSIONLESS	P AE SH AH N L AH S
FRAGILION	F R AE JH AH L Y AH N
UNKISSED	AH N K IH S T
COUNSELLED	K AW N S AH L D
EUKALELI	Y UW K AE L AH L IY
BROADING	B R AO D IH NG
LETHE	L EH DH
A'MASS	AH Z M AE S
ORNATEST	AO R N EY T AH S T
BEWILD'RING	B IH W AY L D R IH NG
SPRINGEST	S P R IH NG AH S T
WHALEBONE	W EY L B OW N
BARTÃ³K	B AA R T
HOSPITALITY'S	HH AA S P AH T AE L AH T IY Z
UNRELUCTANT	AH N R IH L AH K T AH N T
FRUITAGE	F R UW T IH JH
CIRCUMAMBULATE	S ER K AH M AE M B Y AH L AH T
SPECTATEUR	S P EH K T EY T AH R
UNSHORN	AH N SH AO R N
UPROARIOUSLY	AH P R OW R IY AH S L IY
PIPIT	P IH P AH T
CRAGGED	K R AE G D
CYCLONE'S	S IH K L OW N Z
UPGATHER	AH P G AE DH ER
TASSELLED	T AE S AH L D
MALABAR	M AE L AH B AA R
PEWEES	P Y UW IY Z
GORGET	G AO R JH AH T
WAYFARING	W EY F EH R IH NG
TRIUMPH'S	T R AY AH M F S
WHEEZY	W IY Z IY
UNASKED	AH N AE S K T
TOWELLED	T AW AH L D
PLANGENT	P L AE N JH EH N T
DUR	D AH R
PIPIT'S	P IH P AH T S
PUNCHEONS	P AH NG K IY AH N Z
TIENS	T AY AH N Z
TRIUMVIRS	T R AY AH M V AH R Z
SPECTRALLY	S P EH K T R AH L IY
ESTAMINET	EH S T AE M AH N AH T
PENITENTIAL	P EH N AH T EH N CH AH L
UNBLUSHING	AH N B L AH SH IH NG
FERRET'S	F EH R AH TS
BROIDERIES	B R OY D AH R AY Z
ERIN'S	EH R IH N Z
GOOSEQUILL	G UW S K W IH L
WEALDERS	W EH L D AH R Z
INSENTIENT	IH N S EH N CH AH N T
AA	AA
HAHA	HH AH HH AH
SORTA	S AO R T AH
TWAIKU	T W EY K UW
